{
"music": 3,
"tiles": [
0,0,0,0,0,0,0,0,0,0,0,0,0,0,0,0,0,0,0,0,0,0,0,0,0,0,0,0,0,0,0,0,0,0,0,0,0,0,0,0,
0,1,1,1,1,1,1,0,0,0,1,1,1,1,1,1,1,1,1,1,1,1,1,1,1,1,1,1,1,1,1,1,0,0,0,0,0,0,0,0,
0,1,2,0,0,3,1,0,0,0,1,0,0,5,5,0,0,3,0,0,0,0,0,0,0,0,3,0,0,0,4,1,0,0,0,0,0,0,0,0,
0,1,1,1,1,0,1,0,0,0,1,0,1,1,1,1,0,1,0,1,1,1,0,0,0,0,3,0,0,0,0,1,0,0,0,0,0,0,0,0,
0,0,0,0,1,0,1,0,0,0,1,0,1,0,0,1,0,1,0,1,0,1,0,0,0,0,3,0,0,0,0,1,0,0,0,0,0,0,0,0,
0,0,0,0,1,3,1,1,0,1,1,0,1,0,0,1,0,1,0,1,0,1,0,0,0,0,3,0,0,0,0,1,0,0,0,0,0,0,0,0,
0,0,0,0,1,0,0,1,0,1,0,0,1,0,0,1,0,1,0,1,0,1,3,3,3,3,3,3,3,3,3,1,0,0,0,0,0,0,0,0,
0,0,0,0,1,0,1,1,0,1,1,0,1,0,0,1,0,1,0,1,0,1,0,0,0,0,3,0,0,0,0,1,0,0,0,0,0,0,0,0,
0,0,0,1,1,3,1,0,0,0,1,0,1,1,0,1,3,1,3,1,0,1,0,0,0,0,3,0,0,0,0,1,0,0,0,0,0,0,0,0,
0,0,0,1,0,0,1,0,0,0,1,0,0,1,0,1,0,1,0,1,0,1,0,0,0,0,3,0,0,0,0,1,0,0,0,0,0,0,0,0,
0,0,0,1,1,0,1,0,0,0,1,3,1,1,0,1,0,1,0,1,0,1,6,0,0,0,3,0,0,0,0,1,0,0,0,0,0,0,0,0,
0,0,0,0,1,0,1,1,0,1,1,0,1,0,0,1,0,1,0,1,0,1,1,1,1,1,1,1,1,1,1,1,0,0,0,0,0,0,0,0,
0,0,0,0,1,0,0,1,0,1,0,0,1,0,0,1,0,1,0,1,0,0,0,0,0,0,0,0,0,0,0,0,0,0,0,0,0,0,0,0,
0,0,0,0,1,0,1,1,0,1,1,3,1,0,0,1,0,3,0,1,0,0,0,0,0,0,0,0,0,0,0,0,0,0,0,0,0,0,0,0,
0,0,0,0,1,0,1,0,0,0,1,0,1,0,0,1,1,1,1,1,0,0,0,0,0,0,0,0,0,0,0,0,0,0,0,0,0,0,0,0,
0,0,0,0,1,0,1,1,1,1,1,0,1,0,0,0,0,0,0,0,0,0,0,0,0,0,0,0,0,0,0,0,0,0,0,0,0,0,0,0,
0,0,0,0,1,0,0,0,5,0,0,3,1,0,0,0,0,0,0,0,0,0,0,0,0,0,0,0,0,0,0,0,0,0,0,0,0,0,0,0,
0,0,0,0,1,1,1,1,1,1,1,1,1,0,0,0,0,0,0,0,0,0,0,0,0,0,0,0,0,0,0,0,0,0,0,0,0,0,0,0,
0,0,0,0,0,0,0,0,0,0,0,0,0,0,0,0,0,0,0,0,0,0,0,0,0,0,0,0,0,0,0,0,0,0,0,0,0,0,0,0,
0,0,0,0,0,0,0,0,0,0,0,0,0,0,0,0,0,0,0,0,0,0,0,0,0,0,0,0,0,0,0,0,0,0,0,0,0,0,0,0,
0,0,0,0,0,0,0,0,0,0,0,0,0,0,0,0,0,0,0,0,0,0,0,0,0,0,0,0,0,0,0,0,0,0,0,0,0,0,0,0,
0,0,0,0,0,0,0,0,0,0,0,0,0,0,0,0,0,0,0,0,0,0,0,0,0,0,0,0,0,0,0,0,0,0,0,0,0,0,0,0,
0,0,0,0,0,0,0,0,0,0,0,0,0,0,0,0,0,0,0,0,0,0,0,0,0,0,0,0,0,0,0,0,0,0,0,0,0,0,0,0,
0,0,0,0,0,0,0,0,0,0,0,0,0,0,0,0,0,0,0,0,0,0,0,0,0,0,0,0,0,0,0,0,0,0,0,0,0,0,0,0,
0,0,0,0,0,0,0,0,0,0,0,0,0,0,0,0,0,0,0,0,0,0,0,0,0,0,0,0,0,0,0,0,0,0,0,0,0,0,0,0,
0,0,0,0,0,0,0,0,0,0,0,0,0,0,0,0,0,0,0,0,0,0,0,0,0,0,0,0,0,0,0,0,0,0,0,0,0,0,0,0,
0,0,0,0,0,0,0,0,0,0,0,0,0,0,0,0,0,0,0,0,0,0,0,0,0,0,0,0,0,0,0,0,0,0,0,0,0,0,0,0,
0,0,0,0,0,0,0,0,0,0,0,0,0,0,0,0,0,0,0,0,0,0,0,0,0,0,0,0,0,0,0,0,0,0,0,0,0,0,0,0,
0,0,0,0,0,0,0,0,0,0,0,0,0,0,0,0,0,0,0,0,0,0,0,0,0,0,0,0,0,0,0,0,0,0,0,0,0,0,0,0,
0,0,0,0,0,0,0,0,0,0,0,0,0,0,0,0,0,0,0,0,0,0,0,0,0,0,0,0,0,0,0,0,0,0,0,0,0,0,0,0
],
"enemyPoints": [
[0,1,[[88,328]],[1,1,1]],
[0,2,[[264,440],[264,264],[296,264],[296,440]],[1,1,1]],
[2,2,[[424,376]],[0,1,1]],
[2,2,[[424,376]],[0,1,1]],
[2,2,[[424,376]],[0,1,1]],
[0,1,[[88,280]],[1,1,1]],
[2,2,[[424,376]],[0,1,1]],
[2,2,[[424,376]],[0,1,1]],
[2,2,[[424,376]],[0,1,1]],
[2,2,[[424,376]],[0,1,1]],
[2,2,[[424,376]],[0,1,1]],
[0,2,{},[1,1,1]],
[2,2,[[424,376]],[0,1,1]],
[2,2,[[424,376]],[0,1,1]],
[2,2,[[424,376]],[0,1,1]],
[2,2,[[424,376]],[0,1,1]],
[2,2,[[424,376]],[0,1,1]],
[0,1,[[88,232]],[1,1,1]],
[0,2,[[264,264],[296,264],[296,440],[264,440]],[1,1,1]],
[0,2,[[296,440],[264,440],[264,264],[296,264]],[1,1,1]],
[2,2,[[424,376]],[0,1,1]],
[2,2,[[424,376]],[0,1,1]],
[0,1.5,[[184,440]],[1,1,1]],
[2,2,[[424,376]],[0,1,1]],
[0,1.5,[[184,392]],[1,1,1]],
[0,2,[[296,264],[296,440],[264,440],[264,264]],[1,1,1]],
[0,1.5,[[184,344]],[1,1,1]]
]
}
