{
"music": 4,
"tiles": [
0,0,0,0,0,0,0,0,0,0,0,0,0,0,0,0,0,0,0,0,0,0,0,0,0,0,0,0,0,0,0,0,0,0,0,0,0,0,0,0,
0,1,1,1,1,1,1,1,1,1,1,1,1,1,1,1,1,1,1,1,1,1,1,1,1,1,1,1,1,1,1,1,1,1,1,1,1,1,1,0,
0,1,0,0,0,0,0,0,0,0,0,0,0,0,0,0,0,0,0,0,0,0,0,0,0,0,0,0,0,0,0,0,0,0,0,0,0,0,1,0,
0,1,0,0,0,0,0,0,0,0,0,0,0,0,0,0,0,0,0,0,0,0,0,0,0,0,0,0,0,0,0,0,0,0,0,0,0,0,1,0,
0,1,0,0,2,0,0,3,3,3,3,3,3,3,3,3,3,3,3,3,3,3,3,3,3,3,3,3,3,3,3,3,0,0,0,0,0,0,1,0,
0,1,0,0,0,0,0,0,0,0,0,0,0,0,0,0,0,0,0,0,0,0,0,0,0,0,0,0,0,0,0,0,0,0,0,0,0,0,1,0,
0,1,0,0,0,0,0,0,0,0,0,0,0,0,0,0,0,0,0,0,0,0,0,0,0,0,0,0,0,0,0,0,0,0,0,0,0,0,1,0,
0,1,1,1,1,1,1,1,1,1,1,1,1,1,1,1,1,1,1,1,1,1,1,1,1,1,1,1,1,1,1,1,1,0,0,3,0,0,1,0,
0,0,0,0,0,0,0,0,0,0,0,0,0,0,0,0,0,0,0,0,0,0,0,0,0,0,0,0,0,0,0,0,1,0,0,3,0,0,1,0,
0,0,0,0,0,0,0,0,0,0,0,0,0,0,0,0,0,0,0,0,0,0,0,0,0,0,0,0,0,0,0,0,1,0,0,3,0,0,1,0,
0,0,0,0,0,0,0,0,0,0,0,0,0,0,0,0,0,0,0,0,0,0,0,0,0,0,0,0,0,0,0,0,1,0,0,3,0,0,1,0,
0,0,0,0,0,0,0,0,0,0,0,0,0,0,0,0,0,0,0,0,0,0,0,0,0,0,0,0,0,0,0,0,1,0,0,3,0,0,1,0,
0,0,0,0,0,0,0,0,0,0,0,0,0,0,0,0,0,0,0,0,0,0,0,0,0,0,0,0,0,0,0,0,1,0,0,3,0,0,1,0,
0,0,0,0,0,0,0,0,0,0,0,0,0,0,0,0,0,0,0,0,0,0,0,0,0,0,0,0,0,0,0,0,1,0,0,3,0,0,1,0,
0,0,0,0,0,0,0,0,0,0,0,0,0,0,0,0,0,0,0,0,0,0,0,0,0,0,0,0,0,0,0,0,1,0,0,3,0,0,1,0,
0,0,0,0,0,0,0,0,0,0,0,0,0,0,0,0,0,0,0,0,0,0,0,0,0,0,0,0,0,0,0,0,1,0,0,3,0,0,1,0,
0,0,0,0,0,0,0,1,1,1,1,1,1,1,1,1,1,1,1,1,1,1,1,1,1,1,1,1,1,1,1,1,1,0,0,3,0,0,1,0,
0,0,0,0,0,0,0,1,0,0,0,0,0,0,0,0,0,0,0,0,0,0,0,0,0,0,0,0,0,0,0,0,0,0,0,0,0,0,1,0,
0,0,0,0,0,0,0,1,0,0,0,0,0,0,0,0,0,0,0,0,0,0,0,0,0,0,0,0,0,0,0,0,0,0,0,0,0,0,1,0,
0,0,0,0,0,0,0,1,0,0,4,0,0,3,3,3,3,3,3,3,3,3,3,3,3,3,3,3,3,3,3,3,3,0,0,0,0,0,1,0,
0,0,0,0,0,0,0,1,0,0,0,0,0,0,0,0,0,0,0,0,0,0,0,0,0,0,0,0,0,0,0,0,0,0,0,0,6,6,1,0,
0,0,0,0,0,0,0,1,0,0,0,0,0,0,0,0,0,0,0,0,0,0,0,0,0,0,0,0,0,0,0,0,0,0,0,0,6,6,1,0,
0,0,0,0,0,0,0,1,1,1,1,1,1,1,1,1,1,1,1,1,1,1,1,1,1,1,1,1,1,1,1,1,1,1,1,1,1,1,1,0,
0,0,0,0,0,0,0,0,0,0,0,0,0,0,0,0,0,0,0,0,0,0,0,0,0,0,0,0,0,0,0,0,0,0,0,0,0,0,0,0,
0,0,0,0,0,0,0,0,0,0,0,0,0,0,0,0,0,0,0,0,0,0,0,0,0,0,0,0,0,0,0,0,0,0,0,0,0,0,0,0,
0,0,0,0,0,0,0,0,0,0,0,0,0,0,0,0,0,0,0,0,0,0,0,0,0,0,0,0,0,0,0,0,0,0,0,0,0,0,0,0,
0,0,0,0,0,0,0,0,0,0,0,0,0,0,0,0,0,0,0,0,0,0,0,0,0,0,0,0,0,0,0,0,0,0,0,0,0,0,0,0,
0,0,0,0,0,0,0,0,0,0,0,0,0,0,0,0,0,0,0,0,0,0,0,0,0,0,0,0,0,0,0,0,0,0,0,0,0,0,0,0,
0,0,0,0,0,0,0,0,0,0,0,0,0,0,0,0,0,0,0,0,0,0,0,0,0,0,0,0,0,0,0,0,0,0,0,0,0,0,0,0,
0,0,0,0,0,0,0,0,0,0,0,0,0,0,0,0,0,0,0,0,0,0,0,0,0,0,0,0,0,0,0,0,0,0,0,0,0,0,0,0
],
"enemyPoints": [
[2,4,[[152,408]],[1,1,1]],
[2,4,[[152,408]],[1,1,1]],
[2,4,{},[1,1,1]],
[2,4,[[152,408]],[1,1,1]],
[2,4,[[152,408]],[1,1,1]],
[2,-4,[[232,408]],[1,1,1]],
[2,-4,[[232,408]],[1,1,1]],
[2,-4,{},[1,1,1]],
[2,-4,[[232,408]],[1,1,1]],
[2,-4,[[232,408]],[1,1,1]],
[2,4,[[312,408]],[1,1,1]],
[2,4,[[312,408]],[1,1,1]],
[2,4,{},[1,1,1]],
[2,4,[[312,408]],[1,1,1]],
[2,4,[[312,408]],[1,1,1]],
[2,-4,[[392,408]],[1,1,1]],
[2,-4,[[392,408]],[1,1,1]],
[2,-4,{},[1,1,1]],
[2,-4,[[392,408]],[1,1,1]],
[2,-4,[[392,408]],[1,1,1]],
[2,4,[[472,408]],[1,1,1]],
[2,4,[[472,408]],[1,1,1]],
[2,4,{},[1,1,1]],
[2,4,[[472,408]],[1,1,1]],
[2,4,[[472,408]],[1,1,1]],
[2,4,[[568,328]],[1,1,1]],
[2,4,[[568,328]],[1,1,1]],
[2,4,[[568,328]],[1,1,1]],
[2,4,[[568,328]],[1,1,1]],
[2,4,[[568,328]],[1,1,1]],
[2,-4,[[568,248]],[1,1,1]],
[2,-4,[[568,248]],[1,1,1]],
[2,-4,[[568,248]],[1,1,1]],
[2,-4,[[568,248]],[1,1,1]],
[2,-4,[[568,248]],[1,1,1]],
[2,-4,[[248,168]],[1,1,1]],
[2,-4,[[248,168]],[1,1,1]],
[2,-4,[[248,168]],[1,1,1]],
[2,-4,[[248,168]],[1,1,1]],
[2,-4,[[248,168]],[1,1,1]],
[2,4,[[328,168]],[1,1,1]],
[2,4,[[328,168]],[1,1,1]],
[2,4,[[328,168]],[1,1,1]],
[2,4,[[328,168]],[1,1,1]],
[2,4,[[328,168]],[1,1,1]],
[2,-4,[[408,168]],[1,1,1]],
[2,-4,[[408,168]],[1,1,1]],
[2,-4,[[408,168]],[1,1,1]],
[2,-4,[[408,168]],[1,1,1]],
[2,-4,[[408,168]],[1,1,1]],
[2,4,[[488,168]],[1,1,1]],
[2,4,[[488,168]],[1,1,1]],
[2,4,[[488,168]],[1,1,1]],
[2,4,[[488,168]],[1,1,1]],
[2,4,[[488,168]],[1,1,1]]
]
}
