{
"music": 4,
"tiles": [
0,0,0,0,0,0,0,0,0,0,0,0,0,0,0,0,0,0,0,0,0,0,0,0,0,0,0,0,0,0,0,0,0,0,0,0,0,0,0,0,
0,1,1,1,1,1,1,1,1,1,1,1,1,1,1,1,1,1,1,1,1,1,1,0,0,0,0,0,0,0,0,0,0,0,0,0,0,0,0,0,
0,1,0,0,0,1,0,0,3,0,0,3,0,0,0,0,0,0,0,0,1,0,1,0,0,0,0,0,0,0,0,0,0,0,0,0,0,0,0,0,
0,1,0,2,0,1,3,1,1,1,1,1,1,3,0,0,0,0,0,0,1,0,1,1,1,1,1,1,1,1,0,0,0,0,0,0,0,0,0,0,
0,1,0,0,0,0,0,0,3,0,0,3,0,0,0,0,0,0,0,0,1,0,1,0,0,0,0,0,0,1,0,0,0,0,0,0,0,0,0,0,
0,1,1,1,1,1,1,1,1,1,1,1,1,1,1,1,1,3,0,0,1,0,1,0,0,0,0,0,0,1,0,0,0,0,0,0,0,0,0,0,
0,0,0,0,0,0,0,0,0,0,0,0,0,0,0,0,1,0,0,0,1,0,1,0,0,0,0,0,0,1,0,0,0,0,0,0,0,0,0,0,
0,0,0,0,0,0,0,0,0,0,0,0,0,0,0,0,1,0,0,0,1,0,1,3,3,3,1,3,3,1,0,0,0,0,0,0,0,0,0,0,
0,0,0,0,0,0,0,0,0,0,0,0,0,0,0,0,1,0,0,0,1,0,1,0,0,0,1,0,0,1,0,0,0,0,0,0,0,0,0,0,
0,0,0,0,0,0,0,0,0,0,0,0,0,0,0,0,1,0,0,0,1,0,1,3,0,3,1,0,3,1,0,0,0,0,0,0,0,0,0,0,
0,1,1,1,1,1,1,1,1,1,1,1,1,1,1,1,1,0,0,0,1,0,1,3,0,3,1,0,3,1,0,0,0,0,0,0,0,0,0,0,
0,1,3,0,0,0,0,0,0,0,0,0,0,3,0,5,0,0,0,0,1,0,1,3,0,3,1,0,3,1,0,0,0,0,0,0,0,0,0,0,
0,1,3,0,0,0,0,0,0,0,0,0,0,3,0,5,0,0,0,0,1,0,1,3,0,3,1,0,0,1,0,0,0,0,0,0,0,0,0,0,
0,1,3,0,0,0,0,0,0,0,0,0,0,3,0,5,0,0,0,3,1,0,1,3,0,3,1,3,0,1,0,0,0,0,0,0,0,0,0,0,
0,1,0,0,0,1,1,1,1,1,1,1,1,1,1,1,1,1,1,1,1,0,1,0,0,0,1,3,0,1,0,0,0,0,0,0,0,0,0,0,
0,1,0,0,0,1,0,0,0,0,0,0,0,0,0,0,0,0,0,0,0,0,1,6,6,6,1,3,0,1,0,0,0,0,0,0,0,0,0,0,
0,1,0,0,0,1,1,1,1,1,1,1,1,1,1,1,1,1,1,1,1,1,1,6,6,6,1,0,0,1,0,0,0,0,0,0,0,0,0,0,
0,1,0,0,0,0,0,0,3,0,0,3,0,0,3,0,0,0,1,3,3,3,1,6,6,6,1,0,3,1,0,0,0,0,0,0,0,0,0,0,
0,1,0,0,0,0,0,0,3,0,0,3,0,0,3,0,0,0,1,0,0,0,1,1,1,1,1,0,3,1,0,0,0,0,0,0,0,0,0,0,
0,1,0,0,0,0,0,0,3,0,0,3,0,0,3,0,0,0,3,0,0,0,0,0,0,0,0,0,0,1,0,0,0,0,0,0,0,0,0,0,
0,1,1,1,1,1,1,1,1,1,1,1,1,1,1,1,1,1,1,1,1,1,1,0,0,0,1,1,1,1,0,0,0,0,0,0,0,0,0,0,
0,0,0,0,0,0,0,0,0,0,0,0,0,0,0,0,0,0,0,0,0,0,1,5,5,5,1,0,0,0,0,0,0,0,0,0,0,0,0,0,
0,0,0,0,0,0,0,0,0,0,0,0,0,0,0,0,0,0,0,0,0,0,1,1,1,1,1,0,0,0,0,0,0,0,0,0,0,0,0,0,
0,0,0,0,0,0,0,0,0,0,0,0,0,0,0,0,0,0,0,0,0,0,0,0,0,0,0,0,0,0,0,0,0,0,0,0,0,0,0,0,
0,0,0,0,0,0,0,0,0,0,0,0,0,0,0,0,0,0,0,0,0,0,0,0,0,0,0,0,0,0,0,0,0,0,0,0,0,0,0,0,
0,0,0,0,0,0,0,0,0,0,0,0,0,0,0,0,0,0,0,0,0,0,0,0,0,0,0,0,0,0,0,0,0,0,0,0,0,0,0,0,
0,0,0,0,0,0,0,0,0,0,0,0,0,0,0,0,0,0,0,0,0,0,0,0,0,0,0,0,0,0,0,0,0,0,0,0,0,0,0,0,
0,0,0,0,0,0,0,0,0,0,0,0,0,0,0,0,0,0,0,0,0,0,0,0,0,0,0,0,0,0,0,0,0,0,0,0,0,0,0,0,
0,0,0,0,0,0,0,0,0,0,0,0,0,0,0,0,0,0,0,0,0,0,0,0,0,0,0,0,0,0,0,0,0,0,0,0,0,0,0,0,
0,0,0,0,0,0,0,0,0,0,0,0,0,0,0,0,0,0,0,0,0,0,0,0,0,0,0,0,0,0,0,0,0,0,0,0,0,0,0,0
],
"enemyPoints": [
[0,1,[[104,440],[104,408],[216,408],[216,440]],[1,1,1]],
[0,1,[[104,440],[104,408],[216,408],[216,440]],[1,1,1]],
[0,1,[[104,408],[216,408],[216,440],[104,440]],[1,1,1]],
[0,1,[[216,440],[104,440],[104,408],[216,408]],[1,1,1]],
[0,1,[[216,408],[216,440],[104,440],[104,408]],[1,1,1]],
[0,1,[[216,408],[216,440],[104,440],[104,408]],[1,1,1]],
[1,1,[[312,360],[280,328],[312,296],[280,264]],[1,1,1]],
[0,2,[[376,248]],[1,0.5,0]],
[0,2,[[392,248]],[1,0.5,0]],
[0,2,[[408,248]],[1,0.5,0]],
[0,2,[[440,168]],[0,1,1]],
[0,2,[[456,168]],[0,1,1]],
[0,2,{},[1,1,1]],
[0,2,{},[1,1,1]],
[0,2,{},[1,1,1]],
[0,2,{},[1,1,1]],
[0,2,{},[1,1,1]],
[0,2,{},[1,1,1]],
[0,2,[[200,296]],[0,1,1]],
[0,2,[[56,296]],[1,0.5,0]],
[0,2,{},[1,1,1]],
[0,2,{},[1,1,1]],
[0,2,{},[1,1,1]],
[0,2,[[200,280]],[0,1,1]],
[0,2,[[56,280]],[1,0.5,0]],
[0,2,{},[1,1,1]],
[0,2,{},[1,1,1]],
[0,2,[[200,264]],[0,1,1]],
[0,2,[[56,264]],[1,0.5,0]],
[1,1,[[280,296],[312,328],[280,360],[312,392]],[1,1,1]],
[0,2,{},[1,1,1]],
[0,2,{},[1,1,1]],
[0,2,{},[1,1,1]],
[0,2,{},[1,1,1]],
[0,2,{},[1,1,1]],
[0,2,{},[1,1,1]],
[2,2,[[184,168]],[1,1,1]],
[0,2,{},[1,1,1]],
[0,2,{},[1,1,1]],
[0,2,{},[1,1,1]],
[0,2,{},[1,1,1]],
[0,2,{},[1,1,1]],
[2,2,[[136,200]],[1,1,1]],
[2,2,[[184,168]],[1,1,1]],
[2,2,[[232,200]],[1,1,1]],
[0,2,{},[1,1,1]],
[2,2,[[136,200]],[1,1,1]],
[0,2,{},[1,1,1]],
[2,2,[[232,200]],[1,1,1]],
[0,0.5,[[360,168]],[1,1,1]]
]
}
