{
"music": 1,
"tiles": [
0,0,0,0,0,0,0,0,0,0,0,0,0,0,0,0,0,0,0,0,0,0,0,0,0,0,0,0,0,0,0,0,0,0,0,0,0,0,0,0,
0,0,0,0,0,0,0,0,0,0,0,0,0,0,0,0,0,0,0,0,0,0,0,0,0,0,0,0,0,0,0,0,0,0,0,0,0,0,0,0,
0,0,0,0,0,0,0,0,0,0,0,0,0,0,0,0,0,0,0,0,0,0,0,0,0,0,0,0,0,0,0,0,0,0,0,0,0,0,0,0,
0,0,0,0,0,0,0,0,1,1,1,1,1,1,1,0,0,0,0,0,0,0,0,0,0,0,0,0,0,0,0,0,0,0,0,0,0,0,0,0,
0,0,0,0,0,0,0,0,1,0,0,0,0,0,1,0,0,0,0,0,0,0,0,0,0,0,0,0,0,0,0,0,0,0,0,0,0,0,0,0,
0,0,0,1,1,1,1,1,1,0,1,1,1,0,1,0,0,0,0,0,0,0,0,0,0,0,0,0,0,0,0,0,0,0,0,0,0,0,0,0,
0,0,0,1,0,0,0,3,0,0,1,5,1,0,1,0,0,0,0,0,0,0,0,0,0,0,0,0,0,0,0,0,0,0,0,0,0,0,0,0,
0,0,0,1,8,1,1,1,1,1,1,0,1,8,1,1,1,1,1,1,1,1,1,1,0,0,0,0,0,0,0,0,0,0,0,0,0,0,0,0,
0,0,0,1,3,0,0,0,0,3,0,0,0,0,0,3,0,3,0,3,0,3,7,1,0,0,0,0,0,0,0,0,0,0,0,0,0,0,0,0,
0,0,0,1,0,1,1,1,1,1,1,1,1,1,1,1,1,1,1,1,1,1,1,1,0,0,0,0,0,0,0,0,0,0,0,0,0,0,0,0,
0,0,0,1,0,1,0,3,0,0,0,0,0,3,0,3,0,0,0,3,0,0,0,1,0,0,0,0,0,0,0,0,0,0,0,0,0,0,0,0,
0,0,0,1,0,1,0,1,1,1,1,1,1,1,1,0,1,1,1,0,0,1,3,1,0,0,0,1,1,1,1,1,1,1,1,1,0,0,0,0,
0,0,0,1,0,0,0,1,0,0,0,0,0,0,1,3,0,0,0,3,0,1,0,1,0,0,0,1,0,3,0,3,0,3,4,1,0,0,0,0,
0,0,0,1,1,1,1,1,1,1,1,1,1,1,1,1,1,1,1,1,1,1,3,1,0,0,0,1,3,0,0,0,0,0,0,1,0,0,0,0,
0,0,0,1,0,3,0,3,0,3,0,3,0,3,0,3,0,3,0,3,0,1,0,1,0,1,1,1,0,0,0,0,0,0,3,1,0,0,0,0,
0,0,0,1,0,0,0,0,0,0,0,0,0,0,0,0,0,0,0,0,0,1,3,1,0,1,5,1,3,0,0,0,0,0,0,1,0,0,0,0,
0,0,0,1,0,0,0,0,0,0,0,0,0,0,0,0,0,0,0,3,0,1,0,1,1,1,0,1,0,0,0,0,0,0,3,1,0,0,0,0,
0,0,0,1,0,0,0,0,0,0,0,0,0,0,0,0,0,0,0,0,0,0,0,8,0,0,0,0,3,0,3,0,3,0,0,1,0,0,0,0,
0,0,0,1,0,0,0,0,0,0,0,0,0,0,0,0,0,0,0,3,0,1,0,1,1,1,0,1,1,1,1,1,1,1,1,1,0,0,0,0,
0,0,0,1,0,0,0,0,0,0,0,0,0,0,0,0,0,0,0,0,0,1,0,1,0,1,6,1,0,0,0,0,0,0,0,0,0,0,0,0,
0,0,0,1,3,0,3,0,3,0,3,0,3,0,3,0,3,0,3,3,0,1,0,1,0,1,1,1,0,0,0,0,0,0,0,0,0,0,0,0,
0,0,0,1,0,1,1,1,1,1,1,1,1,1,1,1,1,1,1,1,1,1,0,1,0,0,0,0,0,0,0,0,0,0,0,0,0,0,0,0,
0,0,0,1,0,1,3,0,0,0,0,0,0,0,1,5,0,0,3,0,0,3,0,1,0,0,0,0,0,0,0,0,0,0,0,0,0,0,0,0,
0,0,0,1,0,1,3,0,0,0,0,0,0,0,1,1,1,0,1,1,1,1,0,1,0,0,0,0,0,0,0,0,0,0,0,0,0,0,0,0,
0,0,0,1,0,1,3,0,0,0,0,0,0,0,0,0,1,0,3,0,0,3,0,1,0,0,0,0,0,0,0,0,0,0,0,0,0,0,0,0,
0,0,0,1,0,1,3,0,0,0,0,0,0,0,0,0,1,1,1,1,1,1,1,1,0,0,0,0,0,0,0,0,0,0,0,0,0,0,0,0,
0,1,1,1,0,1,3,0,0,0,0,0,0,0,0,0,0,0,0,0,0,0,0,0,0,0,0,0,0,0,0,0,0,0,0,0,0,0,0,0,
0,1,2,0,0,1,0,0,0,0,0,0,0,0,0,0,0,0,0,0,0,0,0,0,0,0,0,0,0,0,0,0,0,0,0,0,0,0,0,0,
0,1,1,1,1,1,0,0,0,0,0,0,0,0,0,0,0,0,0,0,0,0,0,0,0,0,0,0,0,0,0,0,0,0,0,0,0,0,0,0,
0,0,0,0,0,0,0,0,0,0,0,0,0,0,0,0,0,0,0,0,0,0,0,0,0,0,0,0,0,0,0,0,0,0,0,0,0,0,0,0
],
"enemyPoints": [
[0,2,[[72,376],[72,344],[152,344],[152,376]],[1,1,1]],
[0,2,[[152,344],[152,376],[72,376]],[1,1,1]],
[0,2,[[152,376],[72,376],[72,344]],[1,1,1]],
[0,1,[[248,376]],[1,1,1]],
[0,1,[[280,376]],[1,1,1]],
[0,1,[[312,376]],[1,1,1]],
[0,1,[[344,376]],[1,1,1]],
[0,2,[[216,312]],[0,1,1]],
[0,2,[[120,312]],[1,0.5,0]],
[0,2,[[312,312],[312,280],[248,280]],[1,1,1]],
[0,2,[[312,280],[248,280],[248,312]],[1,1,1]],
[2,2,[[376,296]],[1,1,1]],
[0,2,[[248,312],[312,312],[312,280]],[1,1,1]],
[0,2,[[248,280],[248,312],[312,312]],[1,1,1]],
[0,2,[[472,200]],[1,1,1]],
[0,2,[[504,200]],[1,1,1]],
[0,2,[[536,200]],[1,1,1]],
[2,-2,[[376,264]],[1,1,1]],
[0,3,[[552,264]],[1,1,1]],
[0,2,[[88,152]],[1,1,1]],
[0,2,[[120,152]],[1,1,1]],
[0,2,[[152,152]],[1,1,1]],
[0,2,[[184,152]],[1,1,1]],
[0,2,[[216,152]],[1,1,1]],
[0,2,[[248,152]],[1,1,1]],
[0,2,[[280,152]],[1,1,1]],
[0,2,[[312,152]],[1,1,1]],
[0,3,[[456,248]],[1,1,1]],
[2,2,[[376,232]],[1,1,1]],
[0,3,[[552,232]],[1,1,1]],
[0,2,[[72,216]],[1,1,1]],
[0,3,[[456,216]],[1,1,1]],
[0,2,[[456,280]],[1,1,1]],
[0,2,[[488,280]],[1,1,1]],
[0,2,[[520,280]],[1,1,1]],
[0,2,[[72,184]],[1,1,1]],
[0,2,[[72,248]],[1,1,1]],
[0,2,[[104,248]],[1,1,1]],
[0,2,[[136,248]],[1,1,1]],
[0,2,[[168,248]],[1,1,1]],
[0,2,[[200,248]],[1,1,1]],
[0,2,[[232,248]],[1,1,1]],
[0,2,[[264,248]],[1,1,1]],
[0,2,[[296,248]],[1,1,1]],
[0,2,[[72,152]],[1,1,1]],
[2,-4,[[104,88]],[1,1,1]],
[0,1.5,[[280,120],[280,88],[360,88],[360,120]],[1,1,1]],
[0,1.5,[[280,120],[280,88],[360,88],[360,120]],[1,1,1]],
[2,-4,[[104,88]],[1,1,1]],
[0,2,{},[1,1,1]],
[0,1.5,[[360,88],[360,120],[280,120],[280,88]],[1,1,1]],
[0,1.5,[[360,88],[360,120],[280,120],[280,88]],[1,1,1]],
[2,-4,[[104,88]],[1,1,1]],
[2,-4,[[104,88]],[1,1,1]]
]
}
