{
"music": 4,
"tiles": [
0,0,0,0,0,0,0,0,0,0,0,0,0,0,0,0,0,0,0,0,0,0,0,0,0,0,0,0,0,0,0,0,0,0,0,0,0,0,0,0,
0,0,0,0,0,0,0,0,0,0,0,0,0,0,0,0,0,0,0,0,0,0,0,0,0,0,0,0,0,0,0,0,0,0,0,0,0,0,0,0,
0,0,0,0,0,0,0,0,0,0,0,0,0,0,0,0,0,0,0,0,0,0,0,0,0,0,0,0,0,0,0,0,0,0,0,0,0,0,0,0,
0,0,0,0,0,0,0,0,0,0,0,0,0,0,0,0,0,0,0,0,0,0,0,0,0,0,0,0,0,0,0,0,0,0,0,0,0,0,0,0,
0,0,0,0,0,0,0,0,1,1,1,1,1,1,1,1,1,1,1,1,1,1,1,1,1,1,1,1,1,1,1,1,1,0,0,0,0,0,0,0,
0,0,0,0,0,0,0,0,1,0,0,0,1,0,0,0,1,0,0,0,1,0,0,0,1,0,0,0,1,0,0,0,1,0,0,0,0,0,0,0,
0,0,0,0,0,0,0,0,1,0,2,0,3,0,0,0,3,0,0,0,3,0,4,0,3,0,0,0,3,0,1,0,1,0,0,0,0,0,0,0,
0,0,0,0,0,0,0,0,1,0,0,0,1,0,0,0,1,0,3,0,1,0,0,0,1,0,3,0,1,0,0,0,1,0,0,0,0,0,0,0,
0,0,0,0,0,0,0,0,1,1,3,1,1,1,3,1,1,1,3,1,1,1,3,1,1,1,3,1,1,1,3,1,1,0,0,0,0,0,0,0,
0,0,0,0,0,0,0,0,1,0,0,0,1,0,0,0,1,0,0,0,1,0,0,0,1,0,0,0,1,0,0,0,1,0,0,0,0,0,0,0,
0,0,0,0,0,0,0,0,1,0,1,0,3,0,1,0,3,0,0,0,3,0,1,0,3,0,0,0,3,0,1,0,1,0,0,0,0,0,0,0,
0,0,0,0,0,0,0,0,1,0,0,0,1,0,0,0,1,0,0,0,1,0,0,0,1,0,0,0,1,0,0,0,1,0,0,0,0,0,0,0,
0,0,0,0,0,0,0,0,1,1,3,1,1,1,3,1,1,1,3,1,1,1,3,1,1,1,3,1,1,1,3,1,1,0,0,0,0,0,0,0,
0,0,0,0,0,0,0,0,1,0,0,0,1,0,0,0,1,0,0,0,1,0,0,0,1,0,0,0,1,0,0,0,1,0,0,0,0,0,0,0,
0,0,0,0,0,0,0,0,1,0,4,0,3,0,0,0,3,0,0,3,3,0,0,0,3,0,0,0,3,0,1,0,1,0,0,0,0,0,0,0,
0,0,0,0,0,0,0,0,1,0,0,0,1,0,0,0,1,0,0,0,1,0,0,0,1,0,0,0,1,0,0,0,1,0,0,0,0,0,0,0,
0,0,0,0,0,0,0,0,1,1,3,1,1,1,3,1,1,1,3,1,1,1,3,1,1,1,3,1,1,1,3,1,1,0,0,0,0,0,0,0,
0,0,0,0,0,0,0,0,1,0,0,0,1,0,0,0,1,0,0,0,1,0,0,0,1,0,0,0,1,0,0,0,1,0,0,0,0,0,0,0,
0,0,0,0,0,0,0,0,1,0,0,0,3,0,0,0,3,0,1,0,3,0,0,0,3,0,0,0,3,0,1,0,1,0,0,0,0,0,0,0,
0,0,0,0,0,0,0,0,1,0,0,0,1,0,0,0,1,0,0,0,1,0,0,0,1,0,0,0,1,0,0,0,1,0,0,0,0,0,0,0,
0,0,0,0,0,0,0,0,1,1,3,1,1,1,3,1,1,1,3,1,1,1,3,1,1,1,3,1,1,1,3,1,1,0,0,0,0,0,0,0,
0,0,0,0,0,0,0,0,1,0,0,0,1,0,0,0,1,0,0,0,1,0,0,0,1,0,0,0,1,0,0,0,1,0,0,0,0,0,0,0,
0,0,0,0,0,0,0,0,1,0,1,0,3,0,4,0,3,0,0,0,3,0,0,0,3,3,0,0,3,0,6,0,1,0,0,0,0,0,0,0,
0,0,0,0,0,0,0,0,1,0,0,0,1,0,0,0,1,0,0,0,1,0,0,0,1,0,0,0,1,0,0,0,1,0,0,0,0,0,0,0,
0,0,0,0,0,0,0,0,1,1,1,1,1,1,1,1,1,1,1,1,1,1,1,1,1,1,1,1,1,1,1,1,1,0,0,0,0,0,0,0,
0,0,0,0,0,0,0,0,0,0,0,0,0,0,0,0,0,0,0,0,0,0,0,0,0,0,0,0,0,0,0,0,0,0,0,0,0,0,0,0,
0,0,0,0,0,0,0,0,0,0,0,0,0,0,0,0,0,0,0,0,0,0,0,0,0,0,0,0,0,0,0,0,0,0,0,0,0,0,0,0,
0,0,0,0,0,0,0,0,0,0,0,0,0,0,0,0,0,0,0,0,0,0,0,0,0,0,0,0,0,0,0,0,0,0,0,0,0,0,0,0,
0,0,0,0,0,0,0,0,0,0,0,0,0,0,0,0,0,0,0,0,0,0,0,0,0,0,0,0,0,0,0,0,0,0,0,0,0,0,0,0,
0,0,0,0,0,0,0,0,0,0,0,0,0,0,0,0,0,0,0,0,0,0,0,0,0,0,0,0,0,0,0,0,0,0,0,0,0,0,0,0
],
"enemyPoints": [
[0,2,{},[1,0.5,0]],
[0,2,{},[1,0.5,0]],
[0,2,{},[0,1,1]],
[0,2,{},[1,0.5,0]],
[0,2,{},[0,1,1]],
[0,1,[[296,248],[296,376]],[1,1,1]],
[0,1,[[424,184],[424,376]],[1,1,1]],
[0,2,{},[0,1,1]],
[0,2,{},[0,1,1]],
[0,2,{},[1,0.5,0]],
[0,2,{},[0,1,1]],
[0,2,{},[1,0.5,0]],
[0,2,{},[0,1,1]],
[0,2,{},[0,1,1]],
[0,2,{},[0,1,1]],
[0,2,{},[0,1,1]],
[0,2,{},[0,1,1]],
[0,2,{},[0,1,1]],
[0,2,{},[0,1,1]],
[0,2,{},[0,1,1]],
[0,2,{},[1,0.5,0]],
[0,2,{},[0,1,1]],
[0,2,{},[1,0.5,0]],
[0,2,{},[0,1,1]],
[0,2,{},[0,1,1]],
[0,2,{},[1,0.5,0]],
[0,1,[[424,248],[232,248]],[1,1,1]],
[0,2,{},[1,0.5,0]],
[0,2,{},[1,0.5,0]],
[0,2,{},[0,1,1]],
[0,2,{},[1,0.5,0]],
[0,2,{},[1,0.5,0]],
[0,2,{},[0,1,1]],
[0,2,{},[0,1,1]],
[0,2,{},[1,0.5,0]],
[0,2,{},[0,1,1]],
[0,2,{},[1,0.5,0]],
[0,2,{},[0,1,1]],
[0,2,{},[0,1,1]],
[0,2,{},[1,0.5,0]],
[0,2,{},[0,1,1]],
[0,2,{},[0,1,1]],
[0,2,{},[0,1,1]],
[0,2,{},[0,1,1]],
[0,2,{},[1,0.5,0]],
[0,2,{},[0,1,1]],
[0,2,{},[0,1,1]],
[0,2,{},[0,1,1]],
[0,2,{},[1,0.5,0]],
[0,2,{},[1,0.5,0]],
[0,2,{},[1,0.5,0]],
[0,1,[[296,120],[424,120]],[1,1,1]],
[0,2,{},[1,0.5,0]]
]
}
