{
"music": 2,
"tiles": [
0,0,0,0,0,0,0,0,0,0,0,0,0,0,0,0,0,0,0,0,0,0,0,0,0,0,0,0,0,0,0,0,0,0,0,0,0,0,0,0,
0,0,0,0,0,0,0,0,0,0,0,1,1,1,1,1,1,1,1,1,1,1,1,1,0,0,0,0,0,0,0,0,0,0,0,0,0,0,0,0,
0,0,0,0,0,0,0,0,0,0,0,1,5,5,5,5,5,1,5,5,5,5,5,1,0,0,0,0,0,0,0,0,0,0,0,0,0,0,0,0,
0,0,0,0,0,0,0,0,0,0,0,1,0,0,0,0,0,1,0,0,0,0,0,1,0,0,0,0,0,0,0,0,0,0,0,0,0,0,0,0,
0,0,0,0,0,0,0,0,0,0,0,1,0,0,4,0,0,1,0,0,7,0,0,1,0,0,0,0,0,0,0,0,0,0,0,0,0,0,0,0,
0,0,0,0,0,0,0,0,0,0,0,1,0,0,0,0,0,1,0,0,0,0,0,1,0,0,0,0,0,0,0,0,0,0,0,0,0,0,0,0,
0,0,0,0,0,0,0,0,0,0,0,1,0,0,0,0,0,1,0,0,0,0,0,1,0,0,0,0,0,0,0,0,0,0,0,0,0,0,0,0,
0,0,0,0,0,0,0,0,0,0,0,1,0,0,0,0,0,1,0,0,0,0,0,1,0,0,0,0,0,0,0,0,0,0,0,0,0,0,0,0,
0,0,0,0,0,0,0,0,0,0,0,1,3,3,0,3,3,1,0,0,3,0,0,1,0,0,0,0,0,0,0,0,0,0,0,0,0,0,0,0,
0,0,0,0,0,0,0,0,0,0,0,1,0,0,0,0,0,1,0,0,3,0,0,1,0,0,0,0,0,0,0,0,0,0,0,0,0,0,0,0,
0,0,0,0,0,0,0,0,0,0,0,1,0,0,0,0,0,1,3,3,3,3,3,1,0,0,0,0,0,0,0,0,0,0,0,0,0,0,0,0,
0,0,0,0,0,0,0,0,0,0,0,1,3,3,0,3,3,1,0,0,3,0,0,1,0,0,0,0,0,0,0,0,0,0,0,0,0,0,0,0,
0,0,0,0,0,0,0,0,0,0,0,1,0,0,0,0,0,1,0,0,3,0,0,1,0,0,0,0,0,0,0,0,0,0,0,0,0,0,0,0,
0,0,0,0,0,0,0,0,0,0,0,1,0,0,0,0,0,1,0,0,3,0,0,1,0,0,0,0,0,0,0,0,0,0,0,0,0,0,0,0,
0,0,0,0,0,0,0,0,0,0,0,1,3,3,0,3,3,1,0,0,3,0,0,1,0,0,0,0,0,0,0,0,0,0,0,0,0,0,0,0,
0,0,0,0,0,0,0,0,0,0,0,1,0,0,0,0,0,1,3,3,3,3,3,1,0,0,0,0,0,0,0,0,0,0,0,0,0,0,0,0,
0,0,0,0,0,0,0,0,0,0,0,1,0,0,0,0,0,1,0,0,3,0,0,1,0,0,0,0,0,0,0,0,0,0,0,0,0,0,0,0,
0,0,0,0,0,0,0,0,0,0,0,1,3,3,0,3,3,1,0,0,3,0,0,1,0,0,0,0,0,0,0,0,0,0,0,0,0,0,0,0,
0,0,0,0,0,0,0,0,0,0,0,1,0,0,0,0,0,1,0,0,3,0,0,1,0,0,0,0,0,0,0,0,0,0,0,0,0,0,0,0,
0,0,0,0,0,0,0,0,0,0,0,1,0,0,0,0,0,1,0,0,3,0,0,1,0,0,0,0,0,0,0,0,0,0,0,0,0,0,0,0,
0,0,0,0,0,0,0,0,0,0,0,1,3,3,0,3,3,1,3,3,3,3,3,1,0,0,0,0,0,0,0,0,0,0,0,0,0,0,0,0,
0,0,0,0,0,0,0,0,0,0,0,1,0,0,0,0,0,1,0,0,3,0,0,1,0,0,0,0,0,0,0,0,0,0,0,0,0,0,0,0,
0,0,0,0,0,0,0,0,0,0,0,1,0,0,0,0,0,1,0,0,3,0,0,1,0,0,0,0,0,0,0,0,0,0,0,0,0,0,0,0,
0,0,0,0,0,0,0,0,0,0,0,1,0,0,0,0,0,8,0,0,0,0,0,1,0,0,0,0,0,0,0,0,0,0,0,0,0,0,0,0,
0,0,0,0,0,0,0,0,0,0,0,1,0,0,0,0,0,8,0,0,0,0,0,1,0,0,0,0,0,0,0,0,0,0,0,0,0,0,0,0,
0,0,0,0,0,0,0,0,0,0,0,1,0,0,0,0,0,8,0,0,2,0,0,1,0,0,0,0,0,0,0,0,0,0,0,0,0,0,0,0,
0,0,0,0,0,0,0,0,0,0,0,1,0,0,0,0,0,8,0,0,0,0,0,1,0,0,0,0,0,0,0,0,0,0,0,0,0,0,0,0,
0,0,0,0,0,0,0,0,0,0,0,1,0,0,0,0,0,8,6,6,6,6,6,1,0,0,0,0,0,0,0,0,0,0,0,0,0,0,0,0,
0,0,0,0,0,0,0,0,0,0,0,1,1,1,1,1,1,1,1,1,1,1,1,1,0,0,0,0,0,0,0,0,0,0,0,0,0,0,0,0,
0,0,0,0,0,0,0,0,0,0,0,0,0,0,0,0,0,0,0,0,0,0,0,0,0,0,0,0,0,0,0,0,0,0,0,0,0,0,0,0
],
"enemyPoints": [
[2,4,[[232,344]],[1,1,1]],
[2,4,[[232,344]],[1,1,1]],
[2,4,[[232,344]],[1,1,1]],
[2,4,[[232,344]],[1,1,1]],
[2,3,[[328,312]],[1,1,1]],
[2,3,[[328,312]],[1,1,1]],
[2,3,[[328,312]],[1,1,1]],
[2,3,[[328,312]],[1,1,1]],
[0,2,{},[1,1,1]],
[2,3,[[328,312]],[1,1,1]],
[2,3,[[328,312]],[1,1,1]],
[2,-4,[[232,296]],[1,1,1]],
[2,-4,[[232,296]],[1,1,1]],
[2,-4,[[232,296]],[1,1,1]],
[2,-4,[[232,296]],[1,1,1]],
[2,3,[[328,312]],[1,1,1]],
[2,3,[[328,312]],[1,1,1]],
[2,-3,[[328,232]],[1,1,1]],
[2,4,[[232,248]],[1,1,1]],
[2,4,[[232,248]],[1,1,1]],
[2,4,[[232,248]],[1,1,1]],
[2,4,[[232,248]],[1,1,1]],
[2,-3,[[328,232]],[1,1,1]],
[2,-3,[[328,232]],[1,1,1]],
[2,-3,[[328,232]],[1,1,1]],
[0,2,{},[1,1,1]],
[2,-3,[[328,232]],[1,1,1]],
[2,-3,[[328,232]],[1,1,1]],
[2,-3,[[328,232]],[1,1,1]],
[2,-4,[[232,200]],[1,1,1]],
[2,-4,[[232,200]],[1,1,1]],
[2,-4,[[232,200]],[1,1,1]],
[2,-4,[[232,200]],[1,1,1]],
[2,-3,[[328,232]],[1,1,1]],
[2,3,[[328,152]],[1,1,1]],
[2,3,[[328,152]],[1,1,1]],
[2,4,[[232,152]],[1,1,1]],
[2,4,[[232,152]],[1,1,1]],
[2,4,[[232,152]],[1,1,1]],
[2,4,[[232,152]],[1,1,1]],
[2,3,[[328,152]],[1,1,1]],
[2,3,[[328,152]],[1,1,1]],
[0,2,{},[1,1,1]],
[2,3,[[328,152]],[1,1,1]],
[2,3,[[328,152]],[1,1,1]],
[2,3,[[328,152]],[1,1,1]],
[2,3,[[328,152]],[1,1,1]]
]
}
