{
"music": 2,
"tiles": [
0,0,0,0,0,0,0,0,0,0,0,0,0,0,0,0,0,0,0,0,0,0,0,0,0,0,0,0,0,0,0,0,0,0,0,0,0,0,0,0,
0,0,0,0,0,0,0,0,0,0,0,0,0,0,0,0,0,0,0,0,0,0,0,0,0,0,0,0,0,0,0,0,0,0,0,0,0,0,0,0,
0,0,0,0,0,0,0,0,0,0,0,0,0,0,0,0,0,0,0,0,0,0,0,0,0,0,0,0,0,0,0,0,0,0,0,0,0,0,0,0,
0,0,0,0,0,0,0,0,0,0,0,0,0,0,0,0,0,0,0,0,0,0,0,0,0,0,0,0,0,0,0,0,0,0,0,0,0,0,0,0,
0,0,0,0,0,0,0,0,0,0,0,0,0,0,0,0,0,0,0,0,0,0,0,0,0,0,0,0,0,0,0,0,0,0,0,0,0,0,0,0,
0,0,0,0,0,0,0,0,0,0,0,0,0,0,0,0,0,0,0,0,0,0,0,0,0,0,0,0,0,0,0,0,0,0,0,0,0,0,0,0,
0,0,0,0,0,0,0,0,0,0,0,0,0,0,0,0,0,0,0,0,0,3,3,3,3,3,3,3,0,0,0,0,0,0,0,0,0,0,0,0,
0,0,0,0,0,0,0,0,0,0,0,0,0,0,0,0,0,0,0,0,0,0,0,0,0,0,0,0,0,0,0,0,0,0,0,0,0,0,0,0,
0,0,1,1,1,1,1,1,1,1,1,1,1,1,1,1,1,1,1,1,1,1,1,1,1,1,1,1,1,1,1,1,1,1,1,1,1,1,1,0,
0,0,1,6,6,6,0,0,0,0,3,0,0,0,0,0,0,0,0,3,0,0,0,3,3,3,3,3,3,3,3,3,0,0,0,5,5,5,1,0,
0,0,1,6,6,6,0,0,0,0,3,0,0,0,0,0,0,0,0,3,0,0,0,3,3,3,3,3,3,3,3,3,0,0,0,5,5,5,1,0,
0,0,1,6,6,6,0,0,0,0,3,0,0,0,0,0,0,0,0,3,0,0,0,3,3,3,3,3,3,3,3,3,0,0,0,5,5,5,1,0,
0,0,1,1,1,1,1,1,1,1,1,1,1,1,1,1,1,1,1,1,1,1,1,1,1,1,1,1,1,1,1,1,1,1,1,8,8,8,1,0,
0,0,1,0,0,0,0,0,0,0,0,0,0,0,0,0,0,0,0,0,0,0,0,0,0,0,0,0,0,0,0,0,0,0,0,0,0,0,1,0,
0,0,1,0,0,0,0,0,0,0,0,0,0,0,0,0,0,0,0,0,0,0,0,0,0,0,0,0,0,0,0,0,0,0,0,0,2,0,1,0,
0,0,1,0,0,0,0,0,0,0,0,0,0,0,0,0,0,0,0,0,0,0,0,0,0,0,0,0,0,0,0,0,0,0,0,0,0,0,1,0,
0,0,1,0,0,0,1,1,1,1,1,1,1,1,1,1,1,1,1,1,1,1,1,1,1,1,1,1,1,1,1,1,1,1,1,8,8,8,1,0,
0,0,1,0,0,0,0,0,0,0,0,0,0,0,0,0,0,0,0,0,0,0,0,0,0,0,0,0,0,0,0,0,0,0,0,0,0,0,1,0,
0,0,1,0,0,0,0,0,0,0,0,0,0,0,0,0,0,0,0,0,0,0,0,0,0,0,0,0,0,0,0,0,0,0,0,0,7,0,1,0,
0,0,1,0,0,0,0,0,0,0,0,0,0,0,0,0,0,0,0,0,0,0,0,0,0,0,0,0,0,0,0,0,0,0,0,0,0,0,1,0,
0,0,1,1,1,1,1,1,1,1,1,1,1,1,1,1,1,1,1,1,1,1,1,1,1,1,1,1,1,1,1,1,1,1,1,1,1,1,1,0,
0,0,0,0,0,0,0,0,0,0,0,0,0,0,0,0,0,0,0,0,0,0,0,0,0,0,0,0,0,0,0,0,0,0,0,0,0,0,0,0,
0,0,0,0,0,0,0,0,0,0,0,0,0,0,0,0,0,0,0,0,0,0,0,0,0,0,0,0,0,0,0,0,0,0,0,0,0,0,0,0,
0,0,0,0,0,0,0,0,0,0,0,0,0,0,0,0,0,0,0,0,0,0,0,0,0,0,0,0,0,0,0,0,0,0,0,0,0,0,0,0,
0,0,0,0,0,0,0,0,0,0,0,0,0,0,0,0,0,0,0,0,0,0,0,0,0,0,0,0,0,0,0,0,0,0,0,0,0,0,0,0,
0,0,0,0,0,0,0,0,0,0,0,0,0,0,0,0,0,0,0,0,0,0,0,0,0,0,0,0,0,0,0,0,0,0,0,0,0,0,0,0,
0,0,0,0,0,0,0,0,0,0,0,0,0,0,0,0,0,0,0,0,0,0,0,0,0,0,0,0,0,0,0,0,0,0,0,0,0,0,0,0,
0,0,0,0,0,0,0,0,0,0,0,0,0,0,0,0,0,0,0,0,0,0,0,0,0,0,0,0,0,0,0,0,0,0,0,0,0,0,0,0,
0,0,3,3,3,3,3,3,3,3,3,3,3,3,3,3,3,3,3,3,3,3,3,3,3,3,3,3,3,3,3,3,3,3,3,3,3,3,3,0,
0,0,0,0,0,0,0,0,0,0,0,0,0,0,0,0,0,0,0,0,0,0,0,0,0,0,0,0,0,0,0,0,0,0,0,0,0,0,0,0
],
"enemyPoints": [
[2,2,[[440,376]],[0,1,1]],
[2,2,[[440,376]],[0,1,1]],
[2,2,[[440,376]],[0,1,1]],
[2,2,[[440,376]],[0,1,1]],
[2,2,[[440,376]],[0,1,1]],
[2,2,[[440,376]],[0,1,1]],
[0,2,{},[0,1,1]],
[0,3,[[312,328]],[0,1,1]],
[0,3,[[168,328]],[1,0.5,0]],
[0,2,{},[1,0.5,0]],
[0,2,{},[1,0.5,0]],
[0,2,{},[1,0.5,0]],
[0,2,{},[1,0.5,0]],
[0,2,{},[1,0.5,0]],
[0,2,{},[1,0.5,0]],
[0,2,{},[1,0.5,0]],
[0,2,{},[1,0.5,0]],
[0,2,{},[1,0.5,0]],
[0,3,[[312,312]],[0,1,1]],
[0,3,[[168,312]],[1,0.5,0]],
[0,2,{},[1,0.5,0]],
[0,2,{},[1,0.5,0]],
[0,2,{},[1,0.5,0]],
[0,2,{},[1,0.5,0]],
[0,2,{},[1,0.5,0]],
[0,2,{},[1,0.5,0]],
[0,2,{},[1,0.5,0]],
[0,2,{},[1,0.5,0]],
[0,2,{},[1,0.5,0]],
[0,3,[[312,296]],[0,1,1]],
[0,3,[[168,296]],[1,0.5,0]],
[0,2,{},[1,0.5,0]],
[0,2,{},[1,0.5,0]],
[0,2,{},[1,0.5,0]],
[0,2,{},[1,0.5,0]],
[0,2,{},[1,0.5,0]],
[0,2,{},[1,0.5,0]],
[0,2,{},[1,0.5,0]],
[0,2,{},[1,0.5,0]],
[0,2,{},[1,0.5,0]],
[2,2,[[328,24]],[1,1,1]],
[2,2,[[328,24]],[1,0.5,0]],
[2,2,[[328,24]],[1,0.5,0]],
[2,2,[[328,24]],[1,0.5,0]],
[2,2,[[328,24]],[1,1,1]],
[2,2,[[328,24]],[1,1,1]],
[2,2,[[328,24]],[0,1,1]],
[2,2,[[328,24]],[0,1,1]],
[2,2,[[328,24]],[0,1,1]],
[2,2,[[328,24]],[0,1,1]],
[2,2,[[328,24]],[1,1,1]],
[2,2,[[328,24]],[1,1,1]],
[2,2,[[328,24]],[1,1,1]],
[2,2,[[328,24]],[1,1,1]],
[2,2,[[328,24]],[1,1,1]],
[2,2,[[328,24]],[1,1,1]],
[2,2,[[328,24]],[1,1,1]],
[2,2,[[328,24]],[1,1,1]],
[0,2,{},[1,1,1]],
[2,2,[[328,24]],[1,1,1]],
[2,2,[[328,24]],[1,1,1]],
[2,2,[[328,24]],[1,1,1]],
[2,2,[[328,24]],[1,1,1]],
[2,2,[[328,24]],[1,1,1]],
[2,2,[[328,24]],[1,1,1]],
[2,2,[[328,24]],[1,1,1]],
[2,2,[[328,24]],[1,1,1]],
[2,2,[[328,24]],[1,0.5,0]],
[2,2,[[328,24]],[1,0.5,0]],
[2,2,[[328,24]],[1,0.5,0]],
[2,2,[[328,24]],[1,0.5,0]],
[2,2,[[328,24]],[1,1,1]],
[2,2,[[328,24]],[1,1,1]],
[2,2,[[328,24]],[0,1,1]],
[2,2,[[328,24]],[0,1,1]],
[2,2,[[328,24]],[0,1,1]],
[2,2,[[328,24]],[1,1,1]]
]
}
