{
"music": 2,
"tiles": [
0,0,0,0,0,0,0,0,0,0,0,0,0,0,0,0,0,0,0,0,0,0,0,0,0,0,0,0,0,0,0,0,0,0,0,0,0,0,0,0,
0,0,0,0,0,0,0,0,0,0,0,0,0,0,0,0,0,0,0,0,0,0,0,0,0,0,0,0,0,0,0,0,0,0,0,0,0,0,0,0,
0,0,0,0,0,0,0,0,0,0,0,0,0,0,0,0,0,0,0,0,0,0,0,0,0,0,0,0,0,0,0,0,0,0,0,0,0,0,0,0,
0,0,0,0,0,0,0,0,0,0,0,0,0,0,0,0,0,0,0,0,0,0,0,0,0,0,0,0,0,0,0,0,0,0,0,0,0,0,0,0,
0,0,0,0,0,0,0,0,0,0,0,0,0,0,0,0,0,0,0,0,0,0,0,0,0,0,0,0,0,0,0,0,0,0,0,0,0,0,0,0,
0,0,0,0,0,0,0,1,1,1,1,1,1,1,0,0,0,0,0,0,0,0,0,0,0,0,0,0,0,0,0,0,0,0,0,0,0,0,0,0,
0,0,0,0,0,0,0,1,0,0,3,0,4,1,0,0,0,0,0,0,0,0,0,0,0,0,0,0,0,0,0,0,0,0,0,0,0,0,0,0,
0,0,0,0,0,0,0,1,0,0,3,0,0,1,0,0,0,0,0,0,0,0,0,0,0,0,0,0,0,0,0,0,0,0,0,0,0,0,0,0,
0,0,0,0,0,0,0,1,3,3,3,3,3,1,0,0,0,0,0,0,0,0,0,0,0,0,0,0,0,0,0,0,0,0,0,0,0,0,0,0,
0,0,0,0,0,0,0,1,0,0,3,0,0,1,0,0,0,0,0,0,0,0,0,0,0,0,0,0,0,0,0,0,0,0,0,0,0,0,0,0,
0,0,0,0,0,0,0,1,0,0,3,0,0,1,0,0,0,0,0,0,0,0,0,0,0,0,0,0,0,0,0,0,0,0,0,0,0,0,0,0,
0,1,1,1,1,1,1,1,1,8,8,8,1,1,1,1,1,1,1,1,1,1,1,1,1,1,0,0,0,0,0,0,0,0,0,0,0,0,0,0,
0,1,0,0,0,0,0,1,0,0,3,0,0,1,0,0,3,0,0,1,0,0,3,0,5,1,0,0,0,0,0,0,0,0,0,0,0,0,0,0,
0,1,0,0,0,0,0,0,0,0,3,0,0,0,0,0,3,0,0,0,0,0,0,0,5,1,0,0,0,0,0,0,0,0,0,0,0,0,0,0,
0,1,0,0,2,0,0,0,3,3,3,3,3,0,3,3,3,3,3,0,0,0,0,7,5,1,0,0,0,0,0,0,0,0,0,0,0,0,0,0,
0,1,0,0,0,0,0,0,0,0,3,0,0,0,0,0,3,0,0,0,0,0,0,0,5,1,0,0,0,0,0,0,0,0,0,0,0,0,0,0,
0,1,0,0,0,0,0,1,0,0,3,0,0,1,0,0,3,0,0,1,0,0,0,0,5,1,0,0,0,0,0,0,0,0,0,0,0,0,0,0,
0,1,1,8,8,8,1,1,1,1,1,1,1,1,1,8,8,8,1,1,1,1,1,1,1,1,0,0,0,0,0,0,0,0,0,0,0,0,0,0,
0,1,3,3,3,3,3,1,0,0,0,0,0,1,0,0,3,0,0,1,0,0,0,0,0,0,0,0,0,0,0,0,0,0,0,0,0,0,0,0,
0,1,3,3,3,3,3,1,0,0,0,0,0,1,0,0,3,0,0,1,0,0,0,0,0,0,0,0,0,0,0,0,0,0,0,0,0,0,0,0,
0,1,3,3,3,3,3,1,0,0,0,0,0,1,3,3,3,3,3,1,0,0,0,0,0,0,0,0,0,0,0,0,0,0,0,0,0,0,0,0,
0,1,3,3,3,3,3,1,0,0,0,0,0,1,0,0,3,0,0,1,0,0,0,0,0,0,0,0,0,0,0,0,0,0,0,0,0,0,0,0,
0,1,3,6,6,6,3,1,0,0,0,0,0,1,0,0,3,0,4,1,0,0,0,0,0,0,0,0,0,0,0,0,0,0,0,0,0,0,0,0,
0,1,1,1,1,1,1,1,0,0,0,0,0,1,1,1,1,1,1,1,0,0,0,0,0,0,0,0,0,0,0,0,0,0,0,0,0,0,0,0,
0,0,0,0,0,0,0,0,0,0,0,0,0,0,0,0,0,0,0,0,0,0,0,0,0,0,0,0,0,0,0,0,0,0,0,0,0,0,0,0,
0,0,0,0,0,0,0,0,0,0,0,0,0,0,0,0,0,0,0,0,0,0,0,0,0,0,0,0,0,0,0,0,0,0,0,0,0,0,0,0,
0,0,0,0,0,0,0,0,0,0,0,0,0,0,0,0,0,0,0,0,0,0,0,0,0,0,0,0,0,0,0,0,0,0,0,0,0,0,0,0,
0,0,0,0,0,0,0,0,0,0,0,0,0,0,0,0,0,0,0,0,0,0,0,0,0,0,0,0,0,0,0,0,0,0,0,0,0,0,0,0,
0,0,0,0,0,0,0,0,0,0,0,0,0,0,0,0,0,0,0,0,0,0,0,0,0,0,0,0,0,0,0,0,0,0,0,0,0,0,0,0,
0,0,0,0,0,0,0,0,0,0,0,0,0,0,0,0,0,0,0,0,0,0,0,0,0,0,0,0,0,0,0,0,0,0,0,0,0,0,0,0
],
"enemyPoints": [
[2,-1,[[168,344]],[1,1,1]],
[2,-1,[[168,344]],[1,1,1]],
[2,-1,[[168,344]],[1,1,1]],
[2,-1,[[168,344]],[1,1,1]],
[0,2,{},[1,1,1]],
[2,-1,[[168,344]],[1,1,1]],
[2,-1,[[168,344]],[1,1,1]],
[2,-1,[[168,344]],[1,1,1]],
[2,-1,[[168,344]],[1,1,1]],
[2,1,[[168,248]],[1,1,1]],
[2,-1,[[264,248]],[1,1,1]],
[0,3,[[360,216]],[1,1,1]],
[2,1,[[168,248]],[1,1,1]],
[2,-1,[[264,248]],[1,1,1]],
[2,1,[[168,248]],[1,1,1]],
[2,1,[[168,248]],[1,1,1]],
[0,2,{},[1,1,1]],
[2,1,[[168,248]],[1,1,1]],
[2,1,[[168,248]],[1,1,1]],
[2,-1,[[264,248]],[1,1,1]],
[2,-1,[[264,248]],[1,1,1]],
[0,2,{},[1,1,1]],
[2,-1,[[264,248]],[1,1,1]],
[2,-1,[[264,248]],[1,1,1]],
[2,1,[[168,248]],[1,1,1]],
[2,-1,[[264,248]],[1,1,1]],
[2,1,[[168,248]],[1,1,1]],
[2,-1,[[264,248]],[1,1,1]],
[0,2,{},[1,0.5,0]],
[0,2,{},[1,0.5,0]],
[0,2,{},[1,0.5,0]],
[0,2,{},[1,0.5,0]],
[0,2,{},[1,0.5,0]],
[2,1,[[264,152]],[1,1,1]],
[0,2,{},[1,0.5,0]],
[0,2,{},[1,0.5,0]],
[0,2,{},[1,0.5,0]],
[0,2,{},[1,0.5,0]],
[0,2,{},[1,0.5,0]],
[2,1,[[264,152]],[1,1,1]],
[0,2,{},[1,0.5,0]],
[0,2,{},[1,0.5,0]],
[0,2,{},[1,0.5,0]],
[0,2,{},[1,0.5,0]],
[0,2,{},[1,0.5,0]],
[2,1,[[264,152]],[1,1,1]],
[2,1,[[264,152]],[1,1,1]],
[0,2,{},[1,1,1]],
[2,1,[[264,152]],[1,1,1]],
[2,1,[[264,152]],[1,1,1]],
[0,2,{},[1,0.5,0]],
[0,2,{},[0,1,1]],
[0,2,{},[0,1,1]],
[0,2,{},[0,1,1]],
[0,2,{},[1,0.5,0]],
[2,1,[[264,152]],[1,1,1]],
[0,2,{},[1,0.5,0]],
[0,2,{},[1,0.5,0]],
[2,1,[[264,152]],[1,1,1]]
]
}
