{
"music": 4,
"tiles": [
0,0,0,0,0,0,0,0,0,0,0,0,0,0,0,0,0,0,0,0,0,0,0,0,0,0,0,0,0,0,0,0,0,0,0,0,0,0,0,0,
0,0,0,0,0,0,0,0,0,0,0,0,0,0,0,0,0,0,0,0,0,0,0,0,0,0,0,0,0,0,0,0,0,0,0,0,0,0,0,0,
0,0,0,0,0,0,0,0,0,0,0,0,0,0,0,0,0,0,0,0,0,0,0,0,0,0,0,0,0,0,0,0,0,0,0,0,0,0,0,0,
0,0,0,0,0,0,0,0,0,0,0,0,0,0,0,0,0,0,0,0,0,0,0,0,0,0,0,0,0,0,0,0,0,0,0,0,0,0,0,0,
0,0,0,0,0,0,0,0,0,0,0,0,0,0,0,0,0,0,0,0,0,0,0,0,0,0,0,0,0,0,0,0,0,0,0,0,0,0,0,0,
0,0,0,0,0,0,0,0,0,0,0,0,0,0,0,0,0,0,0,0,0,0,0,0,0,0,0,0,0,0,0,0,0,0,0,0,0,0,0,0,
0,0,0,0,0,0,0,0,0,0,0,0,0,0,0,0,0,0,0,0,0,0,0,0,0,0,0,0,0,0,0,0,0,0,0,0,0,0,0,0,
0,0,0,0,0,0,0,0,0,0,0,0,0,0,0,0,0,0,0,0,0,0,0,0,0,0,0,0,0,0,0,0,0,0,0,0,0,0,0,0,
0,0,0,0,0,0,0,0,0,0,0,0,0,0,0,0,0,0,0,0,0,0,0,0,0,0,0,0,0,0,0,0,0,0,0,0,0,0,0,0,
0,0,0,0,0,0,0,0,0,0,0,0,0,0,0,0,0,0,0,0,0,0,0,0,0,0,0,0,0,0,0,0,0,0,0,0,0,0,0,0,
0,0,0,0,0,0,0,0,0,0,0,0,0,0,0,0,0,0,3,3,3,3,3,0,3,3,3,3,3,3,0,0,0,0,0,0,0,0,0,0,
0,0,0,0,0,0,0,0,0,0,0,0,0,0,0,0,0,0,0,0,0,0,0,0,0,0,0,0,0,0,0,0,0,0,0,0,0,0,0,0,
0,1,1,1,1,1,3,3,3,3,3,3,3,3,3,3,3,3,3,3,3,3,3,3,3,3,3,3,3,3,3,3,3,3,1,1,1,1,1,0,
0,1,0,0,0,0,0,0,0,3,3,0,0,0,0,0,0,3,0,0,0,0,0,3,0,0,0,3,0,0,0,0,0,0,0,6,6,6,1,0,
0,1,0,2,0,0,0,3,0,3,3,3,0,3,0,3,3,3,0,3,3,3,0,3,0,3,0,3,0,3,0,0,0,0,0,6,6,6,1,0,
0,1,0,0,0,0,0,3,0,0,0,0,0,3,0,0,5,0,0,3,0,3,0,5,0,3,0,0,0,3,0,0,0,0,0,6,6,6,1,0,
0,1,1,1,1,1,3,3,3,3,3,3,3,3,3,3,3,3,3,3,3,3,3,3,3,3,3,3,3,3,3,3,3,3,1,1,1,1,1,0,
0,0,0,0,0,0,0,0,0,0,0,0,0,0,0,0,0,0,0,0,0,0,0,0,0,0,0,0,0,0,0,0,0,0,0,0,0,0,0,0,
0,0,0,0,0,0,0,0,0,0,0,0,0,0,0,0,0,0,0,0,0,0,0,0,0,0,0,0,0,0,0,0,0,0,0,0,0,0,0,0,
0,0,0,0,0,0,0,0,0,0,0,0,0,0,0,0,0,0,0,0,0,0,0,0,0,0,0,0,0,0,0,0,0,0,0,0,0,0,0,0,
0,0,0,0,0,0,0,0,0,0,0,0,0,0,0,0,0,0,0,0,0,0,0,0,0,0,0,0,0,0,0,0,0,0,0,0,0,0,0,0,
0,0,0,0,0,0,0,0,0,0,0,0,0,0,0,0,0,0,0,0,0,0,0,0,0,0,0,0,0,0,0,0,0,0,0,0,0,0,0,0,
0,0,0,0,0,0,0,0,0,0,0,0,0,0,0,0,0,0,0,0,0,0,0,0,0,0,0,0,0,0,0,0,0,0,0,0,0,0,0,0,
0,0,0,0,0,0,0,0,0,0,0,0,0,0,0,0,0,0,0,0,0,0,0,0,0,0,0,0,0,0,0,0,0,0,0,0,0,0,0,0,
0,0,0,0,0,0,0,0,0,0,0,0,0,0,0,0,0,0,0,0,0,0,0,0,0,0,0,0,0,0,0,0,0,0,0,0,0,0,0,0,
0,0,0,0,0,0,0,0,0,0,0,0,0,0,0,0,0,0,0,0,0,0,0,0,0,0,0,0,0,0,0,0,0,0,0,0,0,0,0,0,
0,0,0,0,0,0,0,0,0,0,0,0,0,0,0,0,0,0,0,0,0,0,0,0,0,0,0,0,0,0,0,0,0,0,0,0,0,0,0,0,
0,0,0,0,0,0,0,0,0,0,0,0,0,0,0,0,0,0,0,0,0,0,0,0,0,0,0,0,0,0,0,0,0,0,0,0,0,0,0,0,
0,0,0,0,0,0,0,0,0,0,0,0,0,0,0,0,0,0,0,0,0,0,0,0,0,0,0,0,0,0,0,0,0,0,0,0,0,0,0,0,
0,0,0,0,0,0,0,0,0,0,0,0,0,0,0,0,0,0,0,0,0,0,0,0,0,0,0,0,0,0,0,0,0,0,0,0,0,0,0,0
],
"enemyPoints": [
[0,2,[[296,184]],[1,0.5,0]],
[0,2,[[312,184]],[1,0.5,0]],
[0,2,[[328,184]],[1,0.5,0]],
[0,2,[[344,184]],[1,0.5,0]],
[0,2,[[360,184]],[1,0.5,0]],
[0,2,[[392,184]],[1,0.5,0]],
[0,2,[[408,184]],[1,0.5,0]],
[0,2,[[424,184]],[1,0.5,0]],
[0,2,[[440,184]],[1,0.5,0]],
[0,2,[[456,184]],[1,0.5,0]],
[0,2,[[472,184]],[1,0.5,0]],
[0,2,{},[1,1,1]],
[0,2,{},[1,1,1]],
[0,2,{},[1,1,1]],
[0,2,{},[1,1,1]],
[0,2,{},[1,1,1]],
[0,2,{},[1,1,1]],
[0,2,{},[1,1,1]],
[0,2,{},[1,1,1]],
[0,2,{},[1,1,1]],
[0,2,{},[1,1,1]],
[0,2,{},[1,1,1]],
[0,2,{},[1,1,1]],
[0,2,{},[1,1,1]],
[0,2,{},[1,1,1]],
[0,2,{},[1,1,1]],
[0,2,{},[1,1,1]],
[0,2,{},[1,1,1]],
[0,2,{},[1,1,1]],
[0,2,{},[1,1,1]],
[0,2,{},[1,1,1]],
[0,2,{},[1,1,1]],
[0,2,{},[1,1,1]],
[0,2,{},[1,1,1]],
[0,2,{},[1,1,1]],
[0,2,{},[1,1,1]],
[0,2,{},[1,1,1]],
[0,2,{},[1,1,1]],
[0,2,{},[1,1,1]],
[0,2,{},[1,1,1]],
[0,1.5,[[264,264]],[1,1,1]],
[0,2,{},[1,1,1]],
[0,2,{},[1,1,1]],
[0,2,{},[1,1,1]],
[0,2,{},[1,1,1]],
[0,2,{},[1,1,1]],
[0,2,{},[1,1,1]],
[0,2,{},[1,1,1]],
[0,2,{},[1,1,1]],
[0,2,{},[1,1,1]],
[0,2,{},[1,1,1]],
[0,2,{},[1,1,1]],
[0,2,{},[1,1,1]],
[0,2,{},[1,1,1]],
[0,2,{},[1,1,1]],
[0,2,{},[1,1,1]],
[0,2,{},[1,1,1]],
[0,2,{},[1,1,1]],
[0,2,{},[1,1,1]],
[0,2,{},[1,1,1]],
[0,2,{},[1,1,1]],
[0,2,{},[1,1,1]],
[0,2,{},[1,1,1]],
[0,2,{},[1,1,1]],
[0,2,{},[1,1,1]],
[0,2,{},[1,1,1]],
[0,2,{},[1,1,1]],
[0,2,{},[1,1,1]],
[0,2,{},[1,1,1]],
[0,2,{},[1,1,1]],
[0,2,{},[1,1,1]],
[0,2,{},[1,1,1]],
[0,2,{},[1,1,1]],
[0,2,{},[1,1,1]],
[0,2,{},[1,1,1]],
[0,2,{},[1,1,1]],
[0,2,{},[1,1,1]],
[0,2,{},[1,1,1]],
[0,2,{},[1,1,1]],
[0,2,{},[1,1,1]],
[0,2,{},[1,1,1]],
[0,2,{},[1,1,1]],
[0,2,{},[1,1,1]],
[0,2,{},[1,1,1]],
[0,2,{},[1,1,1]],
[0,2,{},[1,1,1]],
[0,2,{},[1,1,1]],
[0,2,{},[1,1,1]],
[0,2,{},[1,1,1]],
[0,2,{},[1,1,1]],
[0,2,{},[1,1,1]],
[0,2,{},[1,1,1]],
[0,2,{},[1,1,1]]
]
}
