{
"music": 4,
"tiles": [
0,0,0,0,0,0,0,0,0,0,0,0,0,0,0,0,0,0,0,0,0,0,0,0,0,0,0,0,0,0,0,0,0,0,0,0,0,0,0,0,
0,1,1,1,1,1,1,1,1,1,1,1,1,1,1,1,1,1,1,1,1,1,1,1,1,1,1,1,1,1,0,0,0,0,0,0,0,0,0,0,
0,1,0,0,0,0,3,0,0,0,0,0,3,0,0,0,0,0,3,0,0,0,0,0,3,0,5,5,5,1,0,0,0,0,0,0,0,0,0,0,
0,1,0,2,0,0,3,0,0,0,0,0,3,0,0,0,0,0,3,0,0,0,0,0,3,0,5,5,5,1,0,0,0,0,0,0,0,0,0,0,
0,1,0,0,0,0,3,0,0,0,0,0,3,0,0,0,0,0,3,0,0,0,0,0,3,0,5,5,5,1,0,0,0,0,0,0,0,0,0,0,
0,1,1,1,1,1,1,1,1,1,1,1,1,1,1,1,1,1,1,1,1,1,1,1,1,1,3,3,3,1,0,0,0,0,0,0,0,0,0,0,
0,0,0,0,0,0,0,0,0,0,0,0,0,0,0,0,0,0,0,0,0,0,0,0,0,1,3,3,3,1,0,0,0,0,0,0,0,0,0,0,
0,0,0,0,0,0,0,0,0,0,0,0,0,0,0,0,0,0,0,0,0,0,0,0,0,1,3,3,3,1,0,0,0,0,0,0,0,0,0,0,
0,0,0,0,0,0,0,0,0,0,0,0,0,0,0,0,0,0,0,0,0,0,0,0,0,1,3,3,3,1,0,0,0,0,0,0,0,0,0,0,
0,0,0,0,0,0,0,0,0,0,0,0,0,0,0,0,0,0,0,0,0,0,0,0,0,1,3,3,3,1,0,0,0,0,0,0,0,0,0,0,
0,0,0,0,0,0,0,0,0,0,0,0,0,0,0,0,0,0,0,0,0,0,0,0,0,1,3,3,3,1,0,0,0,0,0,0,0,0,0,0,
0,0,0,0,0,0,0,0,0,0,0,0,0,0,0,0,0,0,0,0,0,0,0,0,0,1,3,3,3,1,0,0,0,0,0,0,0,0,0,0,
0,0,0,0,0,0,0,3,3,3,0,0,0,0,0,0,0,0,0,0,0,0,0,0,0,1,3,3,3,1,0,0,0,0,0,0,0,0,0,0,
0,0,0,1,1,1,1,1,1,1,1,1,1,1,1,1,1,1,1,1,1,1,1,1,1,1,3,3,3,1,0,0,0,0,0,0,0,0,0,0,
0,0,0,1,6,6,6,3,3,3,0,0,0,3,3,3,3,3,3,3,3,3,3,3,3,3,5,5,5,1,0,0,0,0,0,0,0,0,0,0,
0,0,0,1,6,6,6,3,3,3,0,0,0,3,3,3,3,3,3,3,3,3,3,3,3,3,5,5,5,1,0,0,0,0,0,0,0,0,0,0,
0,0,0,1,6,6,6,3,3,3,0,0,0,3,3,3,3,3,3,3,3,3,3,3,3,3,5,5,5,1,0,0,0,0,0,0,0,0,0,0,
0,0,0,1,1,1,1,1,1,1,1,1,1,1,1,1,1,1,1,1,1,1,1,1,1,1,1,1,1,1,0,0,0,0,0,0,0,0,0,0,
0,0,0,0,0,0,0,3,3,3,0,0,0,0,0,0,0,0,0,0,0,0,0,0,0,0,0,0,0,0,0,0,0,0,0,0,0,0,0,0,
0,0,0,0,0,0,0,0,0,0,0,0,0,0,0,0,0,0,0,0,0,0,0,0,0,0,0,0,0,0,0,0,0,0,0,0,0,0,0,0,
0,0,0,0,0,0,0,0,0,0,0,0,0,0,0,0,0,0,0,3,3,3,3,3,3,3,3,3,0,0,0,0,0,0,0,0,0,0,0,0,
0,0,0,0,0,0,0,0,0,0,0,0,0,0,0,0,0,0,0,0,0,0,0,0,0,0,0,0,0,0,0,0,0,0,0,0,0,0,0,0,
0,0,0,0,0,0,0,0,0,0,0,0,0,0,0,0,0,0,0,0,0,0,0,0,0,0,0,0,0,0,0,0,0,0,0,0,0,0,0,0,
0,0,0,0,0,0,0,0,0,0,0,0,0,0,0,0,0,0,0,0,0,0,0,0,0,0,0,0,0,0,0,0,0,0,0,0,0,0,0,0,
0,0,0,0,0,0,0,0,0,0,0,0,0,0,0,0,0,0,0,0,0,0,0,0,0,0,0,0,0,0,0,0,0,0,0,0,0,0,0,0,
0,0,0,0,0,0,0,0,0,0,0,0,0,0,0,0,0,0,0,0,0,0,0,0,0,0,0,0,0,0,0,0,0,0,0,0,0,0,0,0,
0,0,0,0,0,0,0,0,0,0,0,0,0,0,0,0,0,0,0,0,0,0,0,0,0,0,0,0,0,0,0,0,0,0,0,0,0,0,0,0,
0,0,0,0,0,0,0,0,0,0,0,0,0,0,0,0,0,0,0,0,0,0,0,0,0,0,0,0,0,0,0,0,0,0,0,0,0,0,0,0,
0,0,0,0,0,0,0,0,0,0,0,0,0,0,0,0,0,0,0,0,0,0,0,0,0,0,0,0,0,0,0,0,0,0,0,0,0,0,0,0,
0,0,0,0,0,0,0,0,0,0,0,0,0,0,0,0,0,0,0,0,0,0,0,0,0,0,0,0,0,0,0,0,0,0,0,0,0,0,0,0
],
"enemyPoints": [
[0,2,[[216,440],[88,440]],[0,1,1]],
[0,2,[[88,440],[216,440]],[1,0.5,0]],
[0,2,[[408,440],[280,440]],[0,1,1]],
[0,2,[[280,440],[408,440]],[1,0.5,0]],
[0,2,[[216,424],[88,424]],[0,1,1]],
[0,2,[[88,424],[216,424]],[1,0.5,0]],
[0,2,[[408,424],[280,424]],[0,1,1]],
[0,2,[[280,424],[408,424]],[1,0.5,0]],
[0,2,[[216,408],[88,408]],[0,1,1]],
[0,2,[[88,408],[216,408]],[1,0.5,0]],
[0,2,[[408,408],[280,408]],[0,1,1]],
[0,2,[[280,408],[408,408]],[1,0.5,0]],
[0,2,{},[0,1,1]],
[0,2,{},[1,0.5,0]],
[0,2,{},[0,1,1]],
[0,2,{},[0,1,1]],
[0,2,{},[1,0.5,0]],
[0,2,{},[0,1,1]],
[0,2,{},[0,1,1]],
[0,2,{},[1,0.5,0]],
[0,2,{},[0,1,1]],
[0,2,{},[0,1,1]],
[0,2,{},[1,0.5,0]],
[0,2,{},[0,1,1]],
[0,2,{},[1,0.5,0]],
[0,2,{},[1,0.5,0]],
[0,2,{},[0,1,1]],
[0,2,{},[1,0.5,0]],
[0,2,{},[0,1,1]],
[0,2,{},[0,1,1]],
[0,2,{},[1,0.5,0]],
[0,2,{},[1,0.5,0]],
[0,2,{},[1,0.5,0]],
[0,2,[[120,168],[120,296]],[0,1,1]],
[0,2,[[136,168],[136,296]],[0,1,1]],
[0,2,[[152,168],[152,296]],[0,1,1]],
[0,2,{},[0,1,1]],
[0,2,{},[0,1,1]],
[0,2,{},[1,0.5,0]],
[0,2,{},[0,1,1]],
[0,2,{},[0,1,1]],
[0,2,{},[1,0.5,0]],
[0,2,{},[1,0.5,0]],
[0,2,{},[1,0.5,0]],
[0,2,{},[1,0.5,0]],
[0,2,{},[1,0.5,0]],
[0,2,{},[1,0.5,0]],
[0,2,{},[1,0.5,0]],
[0,2,{},[1,0.5,0]],
[0,2,{},[0,1,1]],
[0,2,{},[1,0.5,0]],
[0,2,{},[1,0.5,0]],
[0,2,{},[1,0.5,0]],
[0,2,{},[1,0.5,0]],
[0,2,{},[1,0.5,0]],
[0,2,{},[0,1,1]],
[0,2,{},[1,0.5,0]],
[0,2,{},[1,0.5,0]],
[0,2,{},[1,0.5,0]],
[0,2,{},[1,0.5,0]],
[0,2,{},[1,0.5,0]],
[0,2,{},[1,0.5,0]],
[0,2,{},[0,1,1]],
[0,2,{},[1,0.5,0]],
[0,2,{},[1,0.5,0]],
[0,2,{},[1,0.5,0]],
[0,2,{},[1,0.5,0]],
[0,2,{},[1,0.5,0]],
[0,2,{},[1,0.5,0]],
[0,2,{},[1,0.5,0]],
[0,2,{},[1,0.5,0]],
[0,2,{},[1,0.5,0]],
[0,2,{},[1,0.5,0]],
[0,2,{},[1,0.5,0]],
[0,2,{},[1,0.5,0]],
[0,2,{},[1,0.5,0]],
[0,2,{},[1,0.5,0]],
[0,2,{},[1,0.5,0]],
[0,2,{},[0,1,1]],
[0,2,{},[1,0.5,0]],
[0,2,{},[1,0.5,0]],
[0,2,{},[1,0.5,0]],
[0,2,{},[1,0.5,0]],
[0,2,{},[1,0.5,0]],
[0,2,{},[0,1,1]],
[0,2,{},[1,0.5,0]],
[0,2,{},[1,0.5,0]],
[0,2,{},[1,0.5,0]],
[0,2,{},[1,0.5,0]],
[0,2,{},[1,0.5,0]],
[0,2,[[120,296],[120,168]],[0,1,1]],
[0,2,[[136,296],[136,168]],[0,1,1]],
[0,2,[[152,296],[152,168]],[0,1,1]],
[2,4,[[312,152]],[0,1,1]],
[2,4,[[312,152]],[0,1,1]],
[2,4,[[312,152]],[0,1,1]],
[2,4,[[312,152]],[0,1,1]],
[2,4,[[312,152]],[0,1,1]],
[2,4,[[312,152]],[0,1,1]],
[2,4,[[312,152]],[0,1,1]],
[2,4,[[312,152]],[0,1,1]],
[2,4,[[312,152]],[0,1,1]]
]
}
