{
"music": 4,
"tiles": [
0,0,0,0,0,0,0,0,0,0,0,0,0,0,0,0,0,0,0,0,0,0,0,0,0,0,0,0,0,0,0,0,0,0,0,0,0,0,0,0,
0,0,0,0,0,0,0,0,0,0,0,0,0,0,0,0,0,0,0,0,0,0,0,0,0,0,0,0,0,0,0,0,0,0,0,0,0,0,0,0,
0,0,0,0,0,0,0,0,0,0,0,0,0,0,0,0,0,0,0,0,3,0,0,0,0,0,0,0,0,0,0,0,0,0,0,0,0,0,0,0,
0,0,0,0,0,0,0,0,0,0,0,0,0,0,0,0,0,0,0,0,3,0,0,0,0,0,0,0,0,0,0,0,0,0,0,0,0,0,0,0,
0,0,0,0,0,1,1,1,1,1,1,0,1,1,1,1,1,1,0,0,3,0,0,0,0,0,0,0,0,0,0,0,0,0,0,0,0,0,0,0,
0,0,0,0,0,1,0,0,0,0,1,1,1,0,0,0,0,1,0,0,3,0,0,0,0,0,0,0,0,0,0,0,0,0,0,0,0,0,0,0,
0,0,0,0,0,1,0,0,0,0,3,3,3,0,0,0,0,1,0,0,3,0,0,0,0,0,0,0,0,0,0,0,0,0,0,0,0,0,0,0,
0,0,0,0,0,1,0,0,0,0,1,1,1,0,0,0,0,1,0,0,3,0,0,0,0,0,0,0,0,0,0,0,0,0,0,0,0,0,0,0,
0,0,0,0,0,1,3,3,3,1,1,0,1,1,0,0,0,1,0,0,3,0,0,0,0,0,0,0,0,0,0,0,0,0,0,0,0,0,0,0,
0,0,0,0,0,1,3,3,3,1,3,3,3,1,0,0,0,1,0,0,3,0,0,0,0,0,0,0,0,0,0,0,0,0,0,0,0,0,0,0,
0,0,0,0,0,1,3,3,3,1,0,0,0,1,3,3,3,1,0,0,3,0,0,0,0,0,0,0,0,0,0,0,0,0,0,0,0,0,0,0,
0,0,0,0,0,1,3,3,3,1,0,0,0,1,3,3,3,1,0,0,3,0,0,0,0,0,0,0,0,0,0,0,0,0,0,0,0,0,0,0,
0,1,1,1,1,1,3,3,3,1,0,0,0,1,3,3,3,1,0,0,0,0,0,0,0,0,0,0,0,0,0,0,0,0,0,0,0,0,0,0,
0,1,0,0,0,0,0,0,0,1,0,0,0,1,3,3,3,1,1,1,1,1,1,1,1,1,1,1,1,1,1,0,0,0,0,0,0,0,0,0,
0,1,0,2,0,0,0,0,0,1,0,0,0,1,3,3,3,0,0,3,3,3,0,0,3,3,3,6,6,6,1,0,0,0,0,0,0,0,0,0,
0,1,0,0,0,0,3,3,3,1,0,0,0,1,3,3,3,0,0,3,3,3,0,0,3,3,3,6,6,6,1,0,0,0,0,0,0,0,0,0,
0,1,1,1,1,1,1,1,1,1,0,0,0,1,3,3,3,0,0,3,3,3,0,0,3,3,3,6,6,6,1,0,0,0,0,0,0,0,0,0,
0,0,0,0,0,0,0,0,0,0,0,0,0,1,3,3,3,0,0,3,3,3,0,0,3,3,3,6,6,6,1,0,0,0,0,0,0,0,0,0,
0,0,0,0,0,0,0,0,0,0,0,0,0,1,1,1,1,1,1,1,1,1,1,1,1,1,1,1,1,1,1,0,0,0,0,0,0,0,0,0,
0,0,0,0,0,0,0,0,0,0,0,0,0,0,0,0,0,0,0,3,3,3,0,0,0,0,0,0,0,0,0,0,0,0,0,0,0,0,0,0,
0,0,0,0,0,0,0,0,0,0,0,0,0,0,0,0,0,0,0,0,0,0,0,0,0,0,0,0,0,0,0,0,0,0,0,0,0,0,0,0,
0,0,0,0,0,0,0,0,0,0,0,0,0,0,0,0,0,0,0,0,0,0,0,0,0,0,0,0,0,0,0,0,0,0,0,0,0,0,0,0,
0,0,0,0,0,0,0,0,0,0,0,0,0,0,0,0,0,0,0,0,0,0,0,0,0,0,0,0,0,0,0,0,0,0,0,0,0,0,0,0,
0,0,0,0,0,0,0,0,0,0,0,0,0,0,0,0,0,0,0,0,0,0,0,0,0,0,0,0,0,0,0,0,0,0,0,0,0,0,0,0,
0,0,0,0,0,0,0,0,0,0,0,0,0,0,0,0,0,0,0,0,0,0,0,0,0,0,0,0,0,0,0,0,0,0,0,0,0,0,0,0,
0,0,0,0,0,0,0,0,0,0,0,0,0,0,0,0,0,0,0,0,0,0,0,0,0,0,0,0,0,0,0,0,0,0,0,0,0,0,0,0,
0,0,0,0,0,0,0,0,0,0,0,0,0,0,0,0,0,0,0,0,0,0,0,0,0,0,0,0,0,0,0,0,0,0,0,0,0,0,0,0,
0,0,0,0,0,0,0,0,0,0,0,0,0,0,0,0,0,0,0,0,0,0,0,0,0,0,0,0,0,0,0,0,0,0,0,0,0,0,0,0,
0,0,0,0,0,0,0,0,0,0,0,0,0,0,0,0,0,0,0,0,0,0,0,0,0,0,0,0,0,0,0,0,0,0,0,0,0,0,0,0,
0,0,0,0,0,0,0,0,0,0,0,0,0,0,0,0,0,0,0,0,0,0,0,0,0,0,0,0,0,0,0,0,0,0,0,0,0,0,0,0
],
"enemyPoints": [
[2,4,[[328,296]],[0,1,1]],
[2,4,[[328,296]],[0,1,1]],
[2,4,[[328,296]],[0,1,1]],
[2,4,[[328,296]],[0,1,1]],
[0,2,{},[1,0.5,0]],
[0,2,{},[1,0.5,0]],
[0,2,{},[1,0.5,0]],
[2,4,[[328,296]],[0,1,1]],
[2,4,[[328,296]],[0,1,1]],
[0,2,{},[1,0.5,0]],
[0,2,{},[1,0.5,0]],
[0,2,{},[1,0.5,0]],
[2,4,[[328,296]],[0,1,1]],
[0,2,{},[1,0.5,0]],
[0,2,{},[1,0.5,0]],
[0,2,{},[1,0.5,0]],
[0,2,[[168,424]],[0,1,1]],
[0,2,[[184,424]],[0,1,1]],
[0,2,[[200,424]],[0,1,1]],
[2,4,[[328,296]],[0,1,1]],
[0,2,{},[1,0.5,0]],
[0,2,{},[1,0.5,0]],
[0,2,{},[1,0.5,0]],
[0,2,{},[1,0.5,0]],
[0,2,{},[1,0.5,0]],
[0,2,{},[1,0.5,0]],
[2,4,[[328,296]],[0,1,1]],
[0,2,{},[1,0.5,0]],
[0,2,{},[1,0.5,0]],
[0,2,{},[1,0.5,0]],
[0,2,{},[1,0.5,0]],
[0,2,{},[1,0.5,0]],
[0,2,{},[1,0.5,0]],
[2,4,[[328,296]],[0,1,1]],
[0,2,{},[1,0.5,0]],
[0,2,{},[1,0.5,0]],
[0,2,{},[1,0.5,0]],
[0,2,{},[1,0.5,0]],
[0,2,{},[1,0.5,0]],
[0,2,{},[1,0.5,0]],
[0,2,{},[1,0.5,0]],
[0,2,{},[1,0.5,0]],
[0,2,{},[1,0.5,0]],
[0,2,{},[1,0.5,0]],
[0,2,{},[1,0.5,0]],
[0,2,{},[1,0.5,0]],
[0,2,{},[1,0.5,0]],
[0,2,{},[1,0.5,0]],
[0,2,{},[1,0.5,0]],
[0,2,{},[1,0.5,0]],
[0,2,{},[1,0.5,0]],
[0,2,{},[1,0.5,0]],
[0,2,[[104,392]],[0,1,1]],
[0,2,[[120,392]],[0,1,1]],
[0,2,[[136,392]],[0,1,1]],
[0,2,{},[1,0.5,0]],
[0,2,{},[1,0.5,0]],
[0,2,{},[1,0.5,0]],
[0,2,{},[1,0.5,0]],
[0,2,{},[1,0.5,0]],
[0,2,{},[1,0.5,0]],
[0,2,{},[1,0.5,0]],
[0,2,{},[1,0.5,0]],
[0,2,{},[1,0.5,0]],
[0,2,{},[1,0.5,0]],
[0,2,{},[1,0.5,0]],
[0,2,{},[1,0.5,0]],
[0,2,{},[1,0.5,0]],
[0,2,{},[1,0.5,0]],
[0,2,{},[1,0.5,0]],
[0,2,{},[1,0.5,0]],
[0,2,{},[1,0.5,0]],
[0,2,{},[1,0.5,0]],
[0,2,{},[1,0.5,0]],
[0,2,{},[1,0.5,0]],
[0,2,{},[1,0.5,0]],
[0,2,{},[1,0.5,0]],
[0,2,{},[1,0.5,0]],
[0,2,{},[1,0.5,0]],
[0,2,{},[1,0.5,0]],
[0,2,{},[1,0.5,0]],
[0,2,{},[1,0.5,0]],
[0,2,[[312,280]],[0,1,1]],
[0,2,[[328,280]],[0,1,1]],
[0,2,[[344,280]],[0,1,1]]
]
}
