{
"music": 2,
"tiles": [
0,0,0,0,0,0,0,0,0,0,0,0,0,0,0,0,0,0,0,0,0,0,0,0,0,0,0,0,0,0,0,0,0,0,0,0,0,0,0,0,
0,0,0,0,0,0,0,0,0,0,0,0,0,0,0,0,0,0,0,0,0,0,0,0,0,0,0,0,0,0,0,0,0,0,0,0,0,0,0,0,
0,0,0,0,0,0,0,0,0,0,0,0,0,0,0,0,0,0,0,0,0,0,0,0,0,0,0,0,0,0,0,0,0,0,0,0,0,0,0,0,
0,0,0,0,0,0,0,0,0,0,0,0,0,0,0,0,0,0,0,0,0,0,0,0,0,0,0,0,0,0,0,0,0,0,0,0,0,0,0,0,
0,0,0,0,0,0,0,0,0,0,0,0,0,0,0,0,0,0,1,1,1,1,1,1,1,1,1,1,1,1,1,1,1,1,1,1,1,1,1,0,
0,0,0,0,0,0,0,0,0,0,0,0,0,0,0,0,0,0,1,0,0,0,3,0,0,3,0,0,3,0,0,3,0,0,3,0,0,0,1,0,
0,0,0,0,0,0,0,0,0,0,0,0,0,0,0,0,0,0,1,0,0,0,3,0,0,3,0,0,3,0,0,3,0,0,3,0,0,0,1,0,
0,0,0,0,0,0,0,0,0,0,0,0,0,0,0,0,0,0,1,0,0,0,3,0,0,3,0,0,3,0,0,3,0,0,3,0,0,0,1,0,
0,0,0,0,0,0,0,0,0,0,0,0,0,0,0,0,0,0,1,0,0,0,1,1,1,1,1,1,1,1,1,1,1,1,1,0,0,0,1,0,
0,0,0,0,0,0,0,0,0,0,0,0,0,0,0,0,0,0,1,0,0,0,1,0,0,0,0,0,0,0,0,0,0,0,1,0,0,0,1,0,
0,0,0,0,0,0,0,0,0,0,0,0,0,0,0,0,0,0,1,0,0,0,1,0,0,0,0,0,0,0,0,0,0,0,1,0,0,0,1,0,
0,0,0,0,0,0,0,0,0,0,0,0,0,0,3,3,3,3,1,5,5,5,1,0,0,0,0,0,0,3,3,3,3,3,1,0,0,0,1,0,
0,0,1,1,1,1,1,1,1,1,1,1,1,1,1,1,1,1,1,8,8,8,1,1,1,1,1,1,1,1,1,1,1,1,1,0,0,0,1,0,
0,0,1,0,0,0,0,0,0,0,0,0,0,0,0,0,0,0,3,0,0,0,3,6,6,0,0,0,0,0,0,0,0,0,3,0,0,0,1,0,
0,0,1,0,3,0,0,0,3,0,0,0,0,0,0,0,0,0,3,0,2,0,3,6,6,0,0,0,0,0,0,0,0,0,3,0,0,0,1,0,
0,0,1,0,0,0,0,0,0,0,0,0,0,0,0,0,0,0,3,0,0,0,3,6,6,0,0,0,0,0,0,0,0,0,3,0,0,0,1,0,
0,0,1,0,0,0,1,1,1,1,1,1,1,1,1,1,1,1,1,8,8,8,1,1,1,1,1,1,1,1,1,1,1,1,1,1,1,1,1,0,
0,0,1,0,0,0,1,0,0,0,0,3,3,3,3,0,0,0,1,0,0,0,1,0,0,3,3,3,0,0,0,0,0,0,0,0,0,0,0,0,
0,0,1,0,3,0,1,0,3,0,0,0,3,0,0,0,3,0,1,0,7,0,1,0,0,0,0,0,0,0,0,0,0,0,0,0,0,0,0,0,
0,0,1,0,0,0,1,0,0,0,0,0,0,0,0,0,0,0,1,0,0,0,1,0,0,0,0,0,0,0,0,0,0,0,0,0,0,0,0,0,
0,0,1,0,0,0,1,1,1,1,1,1,1,1,1,1,1,1,1,0,0,0,1,0,0,0,0,0,0,0,0,0,0,0,0,0,0,0,0,0,
0,0,1,0,0,0,0,0,0,0,0,0,0,0,0,0,0,0,0,0,0,0,1,0,0,0,0,0,0,0,0,0,0,0,0,0,0,0,0,0,
0,0,1,0,0,0,3,0,0,0,3,0,3,0,0,0,3,0,0,0,0,0,1,0,0,0,0,0,0,0,0,0,0,0,0,0,0,0,0,0,
0,0,1,0,0,0,0,0,0,0,0,0,0,0,0,0,0,0,0,0,0,0,1,0,0,0,0,0,0,0,0,0,0,0,0,0,0,0,0,0,
0,0,1,1,1,1,1,1,1,1,1,1,1,1,1,1,1,1,1,1,1,1,1,0,0,0,0,0,0,0,0,0,0,0,0,0,0,0,0,0,
0,0,0,0,0,0,0,0,0,0,0,0,0,0,0,0,0,0,0,0,0,0,0,0,0,0,0,0,0,0,0,0,0,0,0,0,0,0,0,0,
0,0,0,0,0,0,3,0,0,0,3,0,0,0,0,0,0,0,0,0,0,0,0,0,0,0,0,0,0,0,0,0,0,0,0,0,0,0,0,0,
0,0,0,0,0,0,0,0,0,0,0,0,0,0,0,0,0,0,0,0,0,0,0,0,0,0,0,0,0,0,0,0,0,0,0,0,0,0,0,0,
0,0,0,0,0,0,0,0,0,0,0,0,0,0,0,0,0,0,0,0,0,0,0,0,0,0,0,0,0,0,0,0,0,0,0,0,0,0,0,0,
0,0,0,0,0,0,0,0,0,0,0,0,0,0,0,0,0,0,0,0,0,0,0,0,0,0,0,0,0,0,0,0,0,0,0,0,0,0,0,0
],
"enemyPoints": [
[0,2,{},[1,1,1]],
[2,-3,[[408,360]],[1,1,1]],
[0,2,{},[1,1,1]],
[2,-3,[[504,360]],[1,1,1]],
[0,2,{},[1,1,1]],
[2,3,[[360,392]],[1,1,1]],
[2,-3,[[408,360]],[1,1,1]],
[2,3,[[456,392]],[1,1,1]],
[2,-3,[[504,360]],[1,1,1]],
[2,3,[[552,392]],[1,1,1]],
[2,3,[[360,392]],[1,1,1]],
[0,2,{},[1,1,1]],
[2,3,[[456,392]],[1,1,1]],
[0,2,{},[1,1,1]],
[2,3,[[552,392]],[1,1,1]],
[0,2,{},[1,1,1]],
[2,-8,[[232,296]],[1,1,1]],
[2,-8,[[232,296]],[1,1,1]],
[2,-8,[[232,296]],[1,1,1]],
[2,-2,[[536,296]],[1,1,1]],
[2,-2,[[536,296]],[1,1,1]],
[2,-2,[[536,296]],[1,1,1]],
[2,-2,[[536,296]],[1,1,1]],
[0,2,{},[1,1,1]],
[0,2,{},[1,0.5,0]],
[0,2,{},[0,1,1]],
[0,4,[[376,264]],[0,1,1]],
[2,3,[[104,216]],[1,1,1]],
[2,3,[[104,216]],[1,1,1]],
[0,2,{},[1,0.5,0]],
[0,2,{},[0,1,1]],
[0,4,[[376,248]],[0,1,1]],
[0,2,{},[1,0.5,0]],
[0,2,{},[0,1,1]],
[0,4,[[376,232]],[0,1,1]],
[2,8,[[232,200]],[1,1,1]],
[2,8,[[232,200]],[1,1,1]],
[2,8,[[232,200]],[1,1,1]],
[0,2,{},[1,1,1]],
[0,2,[[408,296]],[1,1,1]],
[0,2,[[424,296]],[1,1,1]],
[0,2,[[440,296]],[1,1,1]],
[2,3,[[104,216]],[1,1,1]],
[2,3,[[104,216]],[1,1,1]],
[2,2.5,[[232,152]],[1,1,1]],
[2,2.5,[[232,152]],[1,1,1]],
[2,2.5,[[136,88]],[1,1,1]],
[2,2.5,[[136,88]],[1,1,1]],
[2,2.5,[[232,152]],[1,1,1]],
[2,2.5,[[232,152]],[1,1,1]],
[2,2.5,[[136,88]],[1,1,1]],
[2,2.5,[[136,88]],[1,1,1]]
]
}
