{
"music": 1,
"tiles": [
0,0,0,0,0,0,0,0,0,0,0,0,0,0,0,0,0,0,0,0,0,0,0,0,0,0,0,0,0,0,0,0,0,0,0,0,0,0,0,0,
0,1,1,1,1,1,1,1,1,1,1,1,1,1,1,0,0,0,0,0,0,0,0,0,0,0,0,0,0,0,0,0,0,0,0,0,0,0,0,0,
0,1,2,0,3,0,0,3,0,0,3,0,0,0,1,3,0,0,0,0,0,0,0,0,0,0,0,0,0,0,0,0,0,0,0,0,0,0,0,0,
0,1,1,1,1,1,1,1,1,1,1,1,1,0,1,3,0,0,0,0,0,0,0,0,0,0,0,0,0,0,0,0,0,0,0,0,0,0,0,0,
0,0,0,0,3,0,0,3,0,0,3,0,1,3,1,3,0,0,0,0,0,0,0,0,0,0,0,0,0,0,0,0,0,0,0,0,0,0,0,0,
0,0,0,0,0,0,0,0,0,0,0,0,1,3,1,3,0,0,0,0,0,0,0,0,0,0,0,0,0,0,0,0,0,0,0,0,0,0,0,0,
0,1,1,1,1,1,1,1,1,1,1,1,1,3,1,3,0,0,0,0,0,0,0,0,0,0,0,0,0,0,0,0,0,0,0,0,0,0,0,0,
0,1,0,0,0,3,3,3,0,0,0,0,1,3,1,0,0,0,0,0,0,0,0,0,0,0,0,0,0,0,0,0,0,0,0,0,0,0,0,0,
0,1,0,0,0,0,0,0,0,0,0,0,1,3,1,0,0,0,0,0,0,0,0,0,0,0,0,0,0,0,0,0,0,0,0,0,0,0,0,0,
0,1,0,0,0,0,0,0,0,0,0,0,1,0,1,0,0,0,0,0,1,1,1,1,1,1,1,1,1,0,0,0,0,0,0,0,0,0,0,0,
0,1,3,0,0,0,0,0,3,3,3,0,0,0,1,0,0,0,0,0,1,6,5,0,0,0,0,0,1,0,0,0,0,0,0,0,0,0,0,0,
0,1,0,1,1,1,1,1,1,1,1,1,1,0,1,1,1,1,1,1,1,1,1,1,0,1,0,0,1,0,0,0,0,0,0,0,0,0,0,0,
0,1,0,1,0,0,0,0,0,0,0,0,1,0,1,0,3,0,0,0,0,0,0,8,0,1,3,3,1,0,0,0,0,0,0,0,0,0,0,0,
0,1,0,1,3,0,0,0,0,1,1,1,1,0,1,7,0,0,0,0,3,0,0,1,1,1,0,0,1,0,0,0,0,0,0,0,0,0,0,0,
0,1,0,1,1,1,1,1,1,1,5,0,0,0,1,1,1,1,1,1,1,1,0,1,0,1,0,0,1,0,0,0,0,0,0,0,0,0,0,0,
0,1,0,0,0,0,0,0,4,1,5,0,0,0,0,0,0,3,0,0,3,0,0,1,0,1,3,3,1,0,0,0,0,0,0,0,0,0,0,0,
0,1,1,1,1,1,1,1,1,1,1,1,1,1,1,1,0,1,1,1,1,0,1,1,0,1,0,0,1,0,0,0,0,0,0,0,0,0,0,0,
0,0,0,0,3,0,0,0,0,0,0,0,0,0,0,1,0,1,0,0,1,3,1,0,0,1,0,0,1,0,0,0,0,0,0,0,0,0,0,0,
0,0,0,0,0,0,0,0,0,0,0,0,0,0,0,1,3,1,1,1,1,0,1,1,1,1,0,0,1,0,0,0,0,0,0,0,0,0,0,0,
0,0,0,0,0,0,0,0,0,0,0,0,0,0,0,1,0,1,0,0,1,0,1,0,0,0,0,0,1,0,0,0,0,0,0,0,0,0,0,0,
0,0,0,0,0,0,0,0,0,0,0,0,0,0,0,1,0,1,1,1,1,3,1,0,0,0,0,0,1,0,0,0,0,0,0,0,0,0,0,0,
0,0,0,0,0,0,0,0,0,0,0,0,0,0,0,1,3,0,0,3,0,0,1,3,3,3,3,3,1,0,0,0,0,0,0,0,0,0,0,0,
0,0,0,0,0,0,0,0,0,0,0,0,0,0,0,1,1,1,1,1,1,1,1,0,0,0,0,0,1,0,0,0,0,0,0,0,0,0,0,0,
0,0,0,0,0,0,0,0,0,0,0,0,0,0,0,0,0,0,0,0,0,0,1,0,0,0,0,4,1,0,0,0,0,0,0,0,0,0,0,0,
0,0,0,0,0,0,0,0,0,0,0,0,0,0,0,0,0,0,0,0,0,0,1,1,1,1,1,1,1,0,0,0,0,0,0,0,0,0,0,0,
0,0,0,0,0,0,0,0,0,0,0,0,0,0,0,0,0,0,0,0,0,0,0,0,0,0,0,0,0,0,0,0,0,0,0,0,0,0,0,0,
0,0,0,0,0,0,0,0,0,0,0,0,0,0,0,0,0,0,0,0,0,0,0,0,0,0,0,0,0,0,0,0,0,0,0,0,0,0,0,0,
0,0,0,0,0,0,0,0,0,0,0,0,0,0,0,0,0,0,0,0,0,0,0,0,0,0,0,0,0,0,0,0,0,0,0,0,0,0,0,0,
0,0,0,0,0,0,0,0,0,0,0,0,0,0,0,0,0,0,0,0,0,0,0,0,0,0,0,0,0,0,0,0,0,0,0,0,0,0,0,0,
0,0,0,0,0,0,0,0,0,0,0,0,0,0,0,0,0,0,0,0,0,0,0,0,0,0,0,0,0,0,0,0,0,0,0,0,0,0,0,0
],
"enemyPoints": [
[2,-4,[[72,424]],[1,1,1]],
[2,-4,[[120,424]],[1,1,1]],
[2,-4,[[168,424]],[1,1,1]],
[2,4,[[248,376]],[0,1,1]],
[2,4,[[248,376]],[0,1,1]],
[2,-4,[[72,424]],[1,1,1]],
[2,-4,[[120,424]],[1,1,1]],
[2,-4,[[168,424]],[1,1,1]],
[0,2,{},[1,0.5,0]],
[2,4,[[248,376]],[0,1,1]],
[0,2,{},[1,0.5,0]],
[2,4,[[248,376]],[0,1,1]],
[0,2,{},[1,0.5,0]],
[0,2,{},[0,1,1]],
[2,20,[[104,360]],[1,1,1]],
[0,2,{},[1,1,1]],
[2,20,[[104,360]],[1,1,1]],
[0,2,{},[1,0.5,0]],
[0,2,{},[1,0.5,0]],
[2,8,[[24,312]],[1,1,1]],
[2,20,[[152,312]],[1,1,1]],
[0,2,{},[1,1,1]],
[2,20,[[152,312]],[1,1,1]],
[0,2,[[328,280]],[1,1,1]],
[0,1,[[424,296],[440,296],[440,216],[424,216]],[1,1,1]],
[0,1,[[440,216],[424,216],[424,296],[440,296]],[1,1,1]],
[2,2,[[72,232]],[1,1,1]],
[0,2,[[264,264]],[1,1,1]],
[0,2,[[264,232],[264,136],[344,136],[344,232]],[1,1,1]],
[0,2,[[264,232],[264,136],[344,136],[344,232]],[1,1,1]],
[0,1,[[424,296],[440,296],[440,216],[424,216]],[1,1,1]],
[0,1,[[440,216],[424,216],[424,296],[440,296]],[1,1,1]],
[2,2,[[72,232]],[1,1,1]],
[0,2,[[344,232],[264,232],[264,136],[344,136]],[1,1,1]],
[0,2,[[264,136],[344,136],[344,232],[264,232]],[1,1,1]],
[0,2,[[344,232],[264,232],[264,136],[344,136]],[1,1,1]],
[0,2,[[344,136],[344,232],[264,232]],[1,1,1]],
[0,2,[[344,136],[344,232],[264,232],[264,136]],[1,1,1]],
[2,3,[[408,136]],[1,1,1]],
[2,3,[[408,136]],[1,1,1]],
[0,2,{},[1,1,1]],
[2,3,[[408,136]],[1,1,1]],
[2,3,[[408,136]],[1,1,1]]
]
}
